rnascfg.1.1.tab	UCGUUCGUCCUCAGUGCAGGGCAACAG	.(....(((((......)))))....)
rnascfg.1.2.tab	UUUAUCAGUGACAGAGUUCACUAUAAA	(((((.(((((......))))))))))
rnascfg.1.3.tab	UCUUGCUUCAACAGUGUUUGGACGGAAG	.(((.....................)))
rnascfg.1.4.tab	UCUCUUGCUUCAACAGUGUUUGGAUGGAAC	..............................
rnascfg.1.5.tab	AGUCCUGCUUCAACAGUGCUUGAACGGAAC	.((.(((.(((((......)))))))).))
rnascfg.1.6.tab	UUACCUGCUUCAACAGUGCUUGAACGGCAA	((..(((.(((((......)))))))).))
rnascfg.1.7.tab	GUUGGCGCUUCAACAGUGAUUGAACGGAAC	(.......(((...............))))
rnascfg.1.8.tab	CAGUGCAUUGGUUACUGCAAGCCAAGGGCGGUAGCAUU	.(((((.((((((......))))))........)))))
rnascfg.1.9.tab	CAGCGCUUUGGGAGCUGAAACUCAAGGGCGGUAGCGUA	...(((((((((........))))).))))........
rnascfg.1.10.tab	GGGCAUAUUGGAAGCCGUAAUCCAUGGGCGGUAGCGUG	...(((.......(((..........)))......)))
rnascfg.1.11.tab	GGGCACGUUGGAAGCCAAAAUCCAUGGGCGGUAGCGUG	...(((((((...(((..........)))..)))))))
rnascfg.1.12.tab	GAGCAUAUUGGAAGCUGUAAUCCACGGGCGGCAGCGUG	((..................))((((........))))
rnascfg.1.13.tab	UAGCGCAUUGGGAGCUGUAACUCAAGGGCGGUAGCGUG	..((((.(((((........)))))........)))).
rnascfg.1.14.tab	CAGUGCACUGGUAGCUGAUGAGCCAGGGGCGGUAGCGUG	((.....(((((.........)))))...........))
rnascfg.1.15.tab	CAGUGCUCUGGUAGCUGUAAAGCCAGGGGCGGUAGCGUG	((...(((((((.........))))))).........))
rnascfg.1.16.tab	CAGUGUACUGGUAGCUGUGGAGCCAGGGGCGGUAGCGUG	((...(((((.............(....))))))...))
rnascfg.1.17.tab	CCACGGCGGUGGCUGGGGGCAGCCCCACGGUGGUGGCUGG	(((((...................((((.))))))..)))
rnascfg.1.18.tab	UCACGGUGGCGGCUGGGGGCAGCCCCAUGGUGGUGGCUGG	(((((...................(((...)))))..)))
rnascfg.1.19.tab	UCAUGGUGGCGGCUGGGGGCAACCCCAUGGUGGUGGCACC	((((((..................)))))).((((.))))
rnascfg.1.20.tab	GGGCGGUGGUGGCUGGGGUCAGCCCCAUGGUGGCGGCUGG	(......................((.........)))...
rnascfg.1.21.tab	UCAUGGUGGUGGUUGGGGUCAGCCCCAUGGUGGUGGCUGG	(((.(...................(((...))))...)))
rnascfg.1.22.tab	UCAUGGUGGUGGCUGGGGUCAGCCCCAUGGCGGGGGCUGG	.(..(..................(((.......))))..)
rnascfg.1.23.tab	GGGCGGUGGUGGCUGGGGGCAGCCUCAUGGUGGUGGCUGG	(.......................(((......))))...
rnascfg.1.24.tab	UCAUGGUGGCGGCUGGGGACAGCCUCAUGGUGGUGGCUGG	((((((....(((((....))))))))..........)))
rnascfg.1.25.tab	CUCGCAAGACGACUUGCGAGAUGUAAGCAAUCGGGACGGCCCG	((((((((....))))))))((.......))((((....))))
rnascfg.1.26.tab	UCAUGGUGGUGGCUGGGGGCAACCCCAUGGUGGCGGAGGUUGG	.(((((..................)))))..............
rnascfg.1.27.tab	GGGUGGUGGCGGCUGGGGUCAGCCCCACGGCGGUGGAGGCUGG	(......................((............)))...
rnascfg.1.28.tab	CCAUGGUGGUGGAGGCUGGGGUCAGCCCCAUGGUGGUGGCACC	((((((.....................)))))).((((.))))
rnascfg.1.29.tab	UCACAGUGGCGGCUGGGGACAGCCCCAUGGUGGUGGCGGCUGG	...(((.................((............))))).
rnascfg.1.30.tab	UCACGGUGGUGGCUGGGGACAGCCCCACGGUGGUGGUGGCUGG	(((((........(((((....)))))))...........)))
rnascfg.1.31.tab	CCACAGUGGGGGCAACUGGGGCCAGCCCCAUGGUGGUGGUUGG	(((..(..........((((((..))))))).........)))
rnascfg.1.32.tab	GCAUGGAGGUGGCUGGGGACAGCCACAUGGUGGUGGAGGCUGG	.(......(((((((....)))))))................)
rnascfg.1.33.tab	AACUCGGUGUUUCUCAACACCACCUCUUUGCCUUUGGUUGUGCCU	(....((((((....)))))).......................)
rnascfg.1.34.tab	GCCCGGGGACGGCCCCGGGCCGUUCGCUUCAACGGGGACGACCCC	((((((((....))))))))((((......))))(((.....)))
rnascfg.1.35.tab	UUUGCAGGACGACCUGCAAACGCUUCUUUCACCGGGGACGGCCCC	((((((((....))))))))((..........))(((.....)))
rnascfg.1.36.tab	AAAACGGCUCUUUUCAGAGCCACCUAUUUAUACAAAGAGAUGAAGU	(....((((((....))))))........................)
rnascfg.1.37.tab	AGACACGCAACGGCUUCCUGACGCGUGAAAUUAAAUUAUUGGAGCA	...(((((..............)))))...................
rnascfg.1.38.tab	CCUAGGGCUUACGCCCUAGGCUAAUAAAGUUCGCCCCUUCAGGGCU	((((((((....))))))))..(...........((((..)))).)
rnascfg.1.39.tab	GAACAGGUGGCACUAGCCACCAUAAAUUUUGAGAUAAAAGUUUUAG	((((.((((((....))))))..................))))...
rnascfg.1.40.tab	CCCAGCGAUGAAUCGCUGGGCUAUUGUCCAACGACCCGCCGGGUCG	(((((((((..)))))))))...(((..)))(((((((.)))))))
rnascfg.1.41.tab	ACCCAGGCUUCACUUGAAGCCAUAAUCAUACACUAAUUUUUUACCA	.....(((((((..))))))).........................
rnascfg.1.42.tab	CCUAGCUCUCACGAGCCAGGCUAGCGUAUGCCGUACCUUAGGUACU	.(((((((((..)))...)))))).(......(((((...))))))
rnascfg.1.43.tab	CCUAGCACUUCCGUGCCAGGUUAAUGUAUGGCGUGCCUUCGGCACU	((..((((....)))).............)).(((((...))))).
rnascfg.1.44.tab	GCUAGUUCUCACGAACUAGGCUAAGUUAUGGCGUGCUUUCAGCACU	.(((((((....)))))))(............(((((...))))))
rnascfg.1.45.tab	CCUAGCCCUUACGGGCCAGGCUAAAUUAUGCCGUGCUUUCAGCACU	(((.((((....)))).)))............(((((...))))).
rnascfg.1.46.tab	CCUAGUUCUGACGAAUUAGGCUCAGCUAUGCCGUGCUUUCAGCACU	((((((((....))))))))....(.......(((((...))))))
rnascfg.1.47.tab	CGUGUGGCUAACGCCACACGCUAAUAUCUAUCGGUGCUCUGCACCU	((((((((....))))))))............(((((...))))).
rnascfg.1.48.tab	CCAACGGCCCUCUUUAGGGCCACGAAUCACAUGAAUCCAAAUUGAU	..(..(((((......)))))........................)
rnascfg.1.49.tab	CAAUCGGUCCUUUUCAGGACCACCAUUCAGUUUUUAAAAGGAGGAA	.....((((((....)))))).........................
rnascfg.1.50.tab	CUUUAGGCUUCACUAGAAGCCACCAAAACUAUUUUUCCCGCCAAGU	(((..((((((....)))))).....................))).
rnascfg.1.51.tab	CCAAAGGCUCUUUUCAGAGCCACCCACAUGCGCGCUGAAAAGAUCU	....(((.(((((((((...(............)))))))))))))
rnascfg.1.52.tab	CCAACGGCUCUUUUCAGAGCCACCCACAGAGUCAGAAAAAGUGUCU	..(..((((((....))))))........................)
rnascfg.1.53.tab	CCCACCACUCUCGUGGUGGGCUUAUUUAUUGCGUCGCUGCGCGACU	((((((((....))))))))............(((((...))))).
rnascfg.1.54.tab	CCCACCUCUUACGAGGUGGGCUAUUGCAUUUCGUCGCUUCGCGACU	((((((((....))))))))............(((((...))))).
rnascfg.1.55.tab	CCUCGGGGACGACCUCGAGGCCUCCUGAUACGCAGGGACGACCCUG	((((((((....))))))))(..........)(((((....)))))
rnascfg.1.56.tab	CCGUGGGAUGAAUCCCACGGCUAACAUCAAGCGCCCCGACGGGGCU	(((((((((..)))))))))((.......)).((((((.)))))).
rnascfg.1.57.tab	CCAAAGGCUCUUUUCAGAGCCACCUCAGUGUAUCAGAAAAGUGUAA	.....((((((....)))))).........................
rnascfg.1.58.tab	GCCCGGGGACGACCCCGGGCCGUCGAUGUUCAACGGGGACGACCCCA	((((((((....))))))))..............((((....)))).
rnascfg.1.59.tab	UACGUUCAUCUAUUAUAGACGGAAGUAGCGAAAGCGAAGGAACGCACC	..(((((................................)))))....
rnascfg.1.60.tab	AAUUGCACGCAACGGCUUCCUGACGCGUGAGUUUUAAUUAUCGGAGCA	.....(((((..............)))))...................
rnascfg.1.61.tab	AAUGUUCUACAACGGCUUCCUGACGUAGGGCAAUUCUUUUUUGGAGCA	..((((((((..............))))))))................
rnascfg.1.62.tab	AAUCGGCCACAACGGCUUCCUGACGUGGCUAAGAAAUCUAUUGGAGCA	.....(((((..............)))))...................
rnascfg.1.63.tab	UCCUCUCACAACGGCUUCCUGACGUGACGAGGUUAACCCAAUGGAGCA	(((((((((..............)))).))))...............)
rnascfg.1.64.tab	AUUCUGUCACAACGGCUUCCUGACGUGGCAGAGAUUUUUAAUGGAGCA	.(((((((((..............))))))))...............)
rnascfg.1.65.tab	AAUCUGCCACAACGGCUUCCUGACGUGGCUAUUUAAUCUAUUGGAGCA	.....(((((..............)))))...................
rnascfg.1.66.tab	GGGCCGGGACGACCCGCCCCUUUUCCCCUCACCUCCGGGACGGCCCGG	((((((......((((...................)))).))))))..
rnascfg.1.67.tab	UUCCAGGACAUAUUGAUGAGGAUGUCAAAAAUGCAGUUGGGGUCCUCA	(...(((((................................))))).)
rnascfg.1.68.tab	UGCCAGGACAUUCUGCGGAGGAUGUCAAAAAUGCAAUUGGGAUCCUCA	((..((((((((((....))))))))..................))))
rnascfg.1.69.tab	UUCCAGGACAUACUAAUGAGGAUGUCAAAAAUGCAAUUGGAGUCCUCA	(...(((((................................))))).)
rnascfg.1.70.tab	CGGUGGGGACGACCCCACCCUUCGCAAAGUUUCGCGGGGACGACCCCG	((((((((....)))))))..............)(((((....)))))
rnascfg.1.71.tab	UUCCAGGACAUGCUAACGAGGAUGUCAAAAAUGCAAUUGGGGCCCUCA	((....(((((..........)))))........)).(((((.)))))
rnascfg.1.72.tab	UUCCAGGACAUACUGGUGAGGAUGUCAAAAAUGCAAUUGGCGUACUCA	..((((......))))((((........................))))
rnascfg.1.73.tab	UUCCAGGACAUACUGAUGAGGAUGUCAAAAAUGCAGUUGGGGCCCUCG	...(((......))).(((((......................)))))
rnascfg.1.74.tab	UUCCAGGACAUACUAACGAGGAUGUCAAAAAUGCAAUUGAGAUCCUCA	.(((.))).........((((((..................)))))).
rnascfg.1.75.tab	AACGUUCACCCGAAAGGGCGGAAGUAGGCGGUCGCUGAAGGAACGCACC	..(((((.(((....)))......................)))))....
rnascfg.1.76.tab	AACGUUCACCCGUAAGGGCGGAAGUAAGCGAUCGCUGAAGGAACGCACC	..(((((.(((....)))........((((..))))....)))))....
rnascfg.1.77.tab	AUCGUUGGACUAUUAAGUCGGAAGUAGGCAUAAGCCGAAGCAACGCACC	..(((((..........((((.............))))..)))))....
rnascfg.1.78.tab	AUCGUUCAUCUCAUCAUUGAGACGCAAGUAAGCCGACUCGGAACGGAAU	(((((((.(((((....)))))..................)))))..))
rnascfg.1.79.tab	UUCGUUCAUCCUCGCAAGAGGACGCAAAAGCCGACUGAAGGAACGGGAA	(((((((.(((((....)))))..................)))))..))
rnascfg.1.80.tab	CAACCGCCACAACGGCUUCCUGACGUGGCGGGGAUAUCAUAACGGAGCA	...(((((((..............)))))))..................
rnascfg.1.81.tab	UCGCUGUCACAACGGCUUCCUGGCGUGGCGGUAAGAUCCCAAUGGAGCG	.((((.................................(((.)))))))
rnascfg.1.82.tab	CCAUGGAGGUGGAGGCUGGGGUCAGCAGCCCCAUGGAGGUGGAGGCUGG	(((.(...........((((((.....)))))))............)))
rnascfg.1.83.tab	GCUUAGGGACGACCUUAAAUACGCCGAUAUCAAUUUGGGGACGACCCCG	((((((((....))))))....))((.....................))
rnascfg.1.84.tab	GGCCGGGGACGACCCUGGCCGCCAGAACGAAAACGGCGGGAGGACCUGG	((((((((....)))))))).((((....................))))
rnascfg.1.85.tab	AUCGUUCAACCCUUUUGGGUCGGAAGUAGGCAAAGCUGAAGGAACGCGCA	.((((((.((((....)))).....................)))))...)
rnascfg.1.86.tab	UACGUUCAUCAUAUAGACGGAAGUACCCAAUCUUGGGGAAGGAACGCACU	.((((((..................(((((..)))))....)))))...)
rnascfg.1.87.tab	AUCGUUCAACCAUUAAGGUCGGAAGUAGGCAAUCGCUGAAGGAACGCACC	..(((((..................................)))))....
rnascfg.1.88.tab	ACCGUUUAACUCGAAAGAGUCGGAAGUAGGGAAAACCGAAGAAACGCACU	(.(((((..(((....)))((((............))))..)))))...)
rnascfg.1.89.tab	AACGUUCAUCCCACUGGGACGGAAGUAAGCAUAAGCUGAAGGAACGCUUC	..(((((.(((((.)))))......................)))))....
rnascfg.1.90.tab	CACGUUCAUCCUAUUAUAGGACGGAAGUAGCAAUAGCGAAGGAACGCACU	.((((((.(((((...)))))....................)))))...)
rnascfg.1.91.tab	AACGUUCAUCCUACGGGACGGAAGUAGGCUUUAUGCUGAAGGAACGCACC	..(((((..(((((.........))))).............)))))....
rnascfg.1.92.tab	GCGCGGGGACGACCCCGCGCCUCCCCAAGAAUUCGGUCGGGACGACCCGC	((((((((....))))))))..............(((((...)))))...
rnascfg.1.93.tab	AGCGAACCACAACGGCUUCCUGACGUGGUUCUUCAUUGGCGAUUGGAGCG	.(((((((((..............)))))))................)).
