rnascfg.3.1.tab	AUUAUCGGAAGCAGUGCCUUCCAUAAU	(((((.(((((......))))))))))
rnascfg.3.2.tab	GUUCCUGCUUCAACAGUGAUUGAACGGAAC	(((((...(((((......))))).)))))
rnascfg.3.3.tab	GUUCUUGCUUCAACAGUGCUUGAACGGAAC	(((((...(((((......))))).)))))
rnascfg.3.4.tab	AGUCUUGCUUCAACAGUGAUUGAACGGAAC	.((.....(((((......)))))....))
rnascfg.3.5.tab	AUUCUUGCCUCAACAGUGAUUGAACGGAAC	.((((....................)))).
rnascfg.3.6.tab	GUUCUUGCUUCAACAGAGAUUGAACGGAAC	(((((...(((((......))))).)))))
rnascfg.3.7.tab	GUUCUUGCUUCAACAGUAUUUGAACGGAAC	(((((....................)))))
rnascfg.3.8.tab	CACACUGGGAGCUGUAACUCAGGGGCGGUAGCUAU	.(..(((((........)))))............)
rnascfg.3.9.tab	CAGCAUACAGGGAGCUGAAACCCCGUGCGGUAGCUAU	.(..........(((((.....(((..)))))))).)
rnascfg.3.10.tab	UAGCGUAUUGGUAGCUGGAAGCCAAGGGCGGUAGCGUG	...((.................(............)))
rnascfg.3.11.tab	CAGUGCAUUGGCUGCUGUGAGCCAAGGGCGGUAGCGUU	.(((((.((((((......))))))........)))))
rnascfg.3.12.tab	CAGUGGAUUGGUAACUGAAAGCCAAGGGCGGUAGCGUG	((..................................))
rnascfg.3.13.tab	GGGCAAUAUAGAGGCCGCAAUCUAUGGGCGGUAGCGUG	..............((((.........)))).......
rnascfg.3.14.tab	CAGCAAUCUAGAAGCUGUAAUCUAGUGGCGGUAGCGUG	((.....(((((........)))))...........))
rnascfg.3.15.tab	CAGCAAUCUGGGGGCUGUAACCCAGGGGCGGUAGCUAU	.(((...(((((........)))))........)))..
rnascfg.3.16.tab	CAGCGAACUGGGGGCUGUAACUCAGGGGCGGUAGCCAA	............(((((....((......)))))))..
rnascfg.3.17.tab	CGGUGGAGGUGGCUGGGGUGCCCCAUCGCGGGUGGCUGG	(((..........(((((..))))))))(.........)
rnascfg.3.18.tab	UCAUGGCGGGGGCUGGGGUCAGCCUCAUGGCGGUGGCUGG	(((.....((((((......))))))...........)))
rnascfg.3.19.tab	UCAUGGUGGUGGCUGGGGGCAGCCCCAUGGUGGUGGUUGG	.(.............(((((.))))).............)
rnascfg.3.20.tab	CCAUGGUGGUGGCUGGGGACAGCCUCAUGGUGGCAGCUGG	(((.......(((((....))))).............)))
rnascfg.3.21.tab	CCAUGGUGGCAGCUGGGGACAGCCCCAUGGUGGUGGUAGC	((((((.....((((....)))).))))))..........
rnascfg.3.22.tab	GGGCGGUGGCGGCUGGGGUCAACCCCAUGGUGGUGGUUGG	.............((((((..)))))).............
rnascfg.3.23.tab	UCAUGGUGGCGGCUGGGGACAGCCCCACGGUGGUGGUUGG	.(........(((((....)))))((((....))))...)
rnascfg.3.24.tab	UCAUGGAGGUGGCUGGGGCCAGCCUCAUGGAGGUGGCUGG	(((.......((((((..)))))).............)))
rnascfg.3.25.tab	CCAUGGUGGUGGAUGGGGACAGCCCCAUGGUGGUGGCUGG	(((.........((((((....)))))).........)))
rnascfg.3.26.tab	CCAGGGUGGUGGCUGGGGGCAACCCCAUGGUGGCGGCUGG	((((.........(((((....))))).........))))
rnascfg.3.27.tab	CCACGGUGGUGGCUGGGGACAACCCCAUGGGGGCAGCUGG	(((..........(((((....)))))..........)))
rnascfg.3.28.tab	UCAUGGUGGUAGUUGGGGUCAGCCCCAUGGCGGUGGAUGG	((((.........((((((..)))))).........))))
rnascfg.3.29.tab	UCGUAAGGACGACCUUGCGUUUUCACGAACGGGGACGGCCCC	((((....................))))..((((....))))
rnascfg.3.30.tab	CCAAGGAGGUGGAGGCUGGGGACAGCCUCAUGGAGGUGGCUGG	(((........(((((((....)))))))...........)))
rnascfg.3.31.tab	UCAGGGAGGGGGUGGCUGGGGUCAGCCCCAUGGAGGUGGCUGG	((((............((((((..)))))).........))))
rnascfg.3.32.tab	CCACGGAGGCGGCUGGGGACCCAGCUCUCUGGGAGGUGGUGGG	((.........((((((..))))))................))
rnascfg.3.33.tab	CCAGGGAGGGGGUGGCUGGGGACAGCCCCACGGAGGUGGCUGG	((((.........(((((....)))))............))))
rnascfg.3.34.tab	AUCGUUCAACCCAUACGGGUCGCAAGUAAGUCACGGAACGGAGC	...((((.((((....))))....................))))
rnascfg.3.35.tab	GCGCCGGGACGACCCGGCGCGUGUACUGGCCUGAGGACGACCUCG	((((((((....))))))))(.........)(((((....)))))
rnascfg.3.36.tab	CUUCCGGGACGACCCGGAGGCAAAAGAAUCCGGCGGGACGACCCG	....((((.....(((((..........)))))........))))
rnascfg.3.37.tab	GCCCGGGGACGACCCCGGGUCAUUCGAUUCAACGGGGACGGCCCC	((((((((....))))))).........................)
rnascfg.3.38.tab	CCAAAGGCUCUUUUAAGAGCCACCCAUUUCAUCUGUGAAAGAGCA	.....((((((....)))))).....(.................)
rnascfg.3.39.tab	CCUAGGGCUUACGCCCUAGGCUAAUAAGGUACGGGCCUUCAGCCCU	.(((((((....)))))))(............((((.....)))))
rnascfg.3.40.tab	AAACUGGAUUUUCUAAAAUCCACCCACUUUCCAAAGAACUAAGAUU	((..(((((((....)))))))....((((..))))........))
rnascfg.3.41.tab	CCCACGGCUGACGCUGUGGGCUACUCUGUGACGCCGCUACGCGGCU	((((((((....)))))))).......(....(((((...))))))
rnascfg.3.42.tab	CCCAGCGAUGAAUCGCUGGGCUAUUUUCGAGCGUCCCGGCGGGACG	(((((((((..)))))))))((.......))(((((((.)))))))
rnascfg.3.43.tab	CAAACGGCUCUUUUCAGAGCCACCACAACCCCAAGAAAGAAUCAUU	.((..((((((....)))))).......................))
rnascfg.3.44.tab	UUUUAGGCUUCACUAGAAGCCACCACAGUUUCCUUUCUCGAAGCAG	((...((((((....)))))).......................))
rnascfg.3.45.tab	CAAACGGUUCUUUUAGGAACCACCACAUAUGACAAGAGUCAUGUCC	.....((...................(((((((....)))))))))
rnascfg.3.46.tab	CCUAGCUCUGACGAGCUAGGCUAAGUUAAUACGUACUUACAGCACU	((((((((....))))))))...(((.................)))
rnascfg.3.47.tab	CCUAGCACUUCCGUGCCAGGCUGAGUUAUGCCGUCCCAUUGGGACU	(((.((((....)))).)))..(.........((((((.)))))))
rnascfg.3.48.tab	CCUAGCUCUCACGAGCCAGGCUGAACUAUACCGUACUCUCGGUACU	(((.((((....)))).)))..(.........(((((...))))))
rnascfg.3.49.tab	ACUAGCACUGACGUGCUAGGCUGAGUUAUGCCGUACCUUCGGUACU	.(((((((....)))))))(............(((((...))))))
rnascfg.3.50.tab	CCUGGCACUUCCGUGCCAGGCUAAUGUAUGUCGUGCUUUCAGCACU	.(((((((....)))))))(............(((((...))))))
rnascfg.3.51.tab	UCUAGCUCUCACGAGCUAGGCUAAAUCAUGGCGUGCUUUCAGCACU	.(((((((....)))))))(............(((((...))))))
rnascfg.3.52.tab	CCCAAGGCUCACGCCUUGGGCUUUAUUAUUUCAUGCCUUCAGCAUU	.(((((((....)))))))(............((((.....)))))
rnascfg.3.53.tab	AACUCGGUGUUUCUCAACACCACCUAGACAAAGAAUCGGAUGUGCU	(....((((((....))))))........................)
rnascfg.3.54.tab	CCUUGGGUUGAAACCCAAGGCUGCCAGAUUCCGUCGCUCCGCGACU	(((((((((..)))))))))..(.........(((((...))))))
rnascfg.3.55.tab	CCAAAGGCUCUUUUAAGAGCCACUCACAUCUUGUAAAGAGUAGAAU	..(..((((((....)))))).......((((...))))......)
rnascfg.3.56.tab	ACAACGGCUCUUUUAAGAGCCACUCACUUUCUACUAAGAGCAGCGU	((...((((((....)))))).......................))
rnascfg.3.57.tab	CCAAAGGCUCUUUUAAGAGCCACCACGUUGCCACUGGGGAGAGCUG	.((..((((((....)))))).......................))
rnascfg.3.58.tab	CCAAAGGCUCUUUUCAGAGCCACCCACGCUGUCAAGGGAAGAGCCU	....(((((((((((....................)))))))))))
rnascfg.3.59.tab	AUCGUUCAUCCCAUAAGGGACGCAAAAGCCGACUGAAGGAACGGGAU	.......(((((..............................)))))
rnascfg.3.60.tab	UACGUUCAUCCAAUGGGACGGAAGUAGGGAAACCGAAGGAACGCACU	...(......................................(..))
rnascfg.3.61.tab	UAUCCGGGACGACCUGGAUAUACUGCCGUUUUCUGGGGACGACUCCA	((((((((....))))))))...((....................))
rnascfg.3.62.tab	CUUCGGGACGACCCGAAGAAAUCUAUGACAGCCUGGGAACGGCCCAG	(((((((....)))))))....((.....)).(((((.....)))))
rnascfg.3.63.tab	GUGCAGGGACGGCCUUGCUUUCUUCUAUCCGGAUGAGGACGGCCUCA	(.........((((..........................)))))..
rnascfg.3.64.tab	UCCUACACGCAACGGCUUCCUGACGCGUGAGGUGUAAUCAUUGGAGCA	(....(((((..............)))))..................)
rnascfg.3.65.tab	AUCGUUUGGCUCAUUGAGUUGGAAGUAAGGUAACUGAAGAAACGCACU	...(.......................................(..))
rnascfg.3.66.tab	UGAAACUUAUAACGGCUACCUGAAGUAAGUUUUUUUAUAAACGGAGCA	(.........................................(...))
rnascfg.3.67.tab	AAUCCCCCACAACGGCUUCCUGGCGUGGCGGUGACAUUCAAUGGAGCA	..(...((((..............))))......((((.))))....)
rnascfg.3.68.tab	UUUCAGGACAUACUGAAGAGGAUGUCAAGAAUGCAAUUGGGGUCCUCA	(..............................................)
rnascfg.3.69.tab	UGCCAGGACAUUCUCAUGAGGAUGUCAAAAAUGCAAUUGGAAUCCUCA	(.....(((((((((..))))))))).....................)
rnascfg.3.70.tab	UUCCAGUACAUACUGAUGAGGAUGUCAAAAAUGCAAUUGGGGUCCUAA	((................................(..........)))
rnascfg.3.71.tab	UGCCGUGGACGACCUCGGCAUGCAUGACCACGUGGCGGGACGACCCGC	((.(((((...................)))))))(((((....)))))
rnascfg.3.72.tab	UUCCAGGACAUACUAGCGAGGAUGUCAAAAAUGCAAUUGGAAUCCUCA	((((((..............................))))))......
rnascfg.3.73.tab	UCCCAGGACAUACUGAUGAGGAUGUCAAAAAUGCGAUUGGGGUCCUCA	((((((..............................)))))......)
rnascfg.3.74.tab	UUCCAGGACAUACUGAUGAGGAUGUCAAAAAUGCAAUUGGGACCCUCA	((((((..............................))))))......
rnascfg.3.75.tab	ACGUCGUCACAACGGCUUCCUGGCGUGACGAUACACAUCUAAUGGAGCA	...(((((((..............)))))))..................
rnascfg.3.76.tab	AUCGUUCAUCCUCUAAUGAGGACGCAACAGUUUGCUGAAGGAACGGGAA	.((((((.(((((....)))))..................)))))...)
rnascfg.3.77.tab	AUCGUUCAACCUCAUAAGAGGUCGCAAGUAAGCCGACUCGGAACGGAUC	.((((((.(((((....)))))..................))))))...
rnascfg.3.78.tab	AUCGUUCAUCCUCUUCGGAGGACGCAAAUGCCGACUGAAGGAACGGGAU	(((.((((((((((..)))))).............)))).......)))
rnascfg.3.79.tab	UCCCCGUCACAACGGCUUCCUGGCGUGACGGCUGGUACCCAAUGGAGCA	(..(((((((..............))))))).................)
rnascfg.3.80.tab	AACCCGUCACAACGGCUUCCUGGCGUGACGGCUGACAUACAAUGGAGCA	...(((((((..............))))))).((.............))
rnascfg.3.81.tab	UUUUAUCCACAACGGCUUCCUGAAGUGGAUCGACAUUUAAACUGGAGCA	(...((((((..............))))))..................)
rnascfg.3.82.tab	AGACUGCCACAACGGCUUCCUGACGUGGUGGAAAAAUCUUACUGGAGCA	....(((.......................................)))
rnascfg.3.83.tab	CCCUGGGGACGACCCCGGCGGCCAAGGCUAUAAAGACGGGACGGCCCGU	(((.((((....)))).....................)))((((.))))
rnascfg.3.84.tab	CGGCCGGGACGACCCGGCCGCACAGGGAGCAUGAGCCGGGACGACCCGG	((((((((....))))))))(.............)(((((....)))))
rnascfg.3.85.tab	AUCGUUCAUCUCCUUAGGGAGACGCAAAAGUCUGACUGAAGGAACGGAAA	.((((((.((((((..))))))...................))))))...
rnascfg.3.86.tab	GACGUUCAUCACAAAUGUGACGGAAGUACCAAUGAGGGAAGGAACGCACC	(............................................(..))
rnascfg.3.87.tab	AUCGUUCAUCCCAAAAGGACGGAAGUAGGCAUUAGCCGAAGGAACGCACC	..((((..............................(....)))))....
rnascfg.3.88.tab	CACGUUCAUCCUAUCAAGGACGGAAGUAGCAUAACGCGAAGGAACGCACC	...((..............................(((......))))).
rnascfg.3.89.tab	AUCGUUCAUCUAUUAUAGACGGAAGUAGGUAUACACCGAAGGAACGCACC	..((((..............................(....)))))....
rnascfg.3.90.tab	CCGCUGUCCCAACGGCUUCCUGACGGGACGGUAUGACAUCCAUCGGAGCG	.(((((((((..............))))).................))))
