mmrnascfg.5.1.tab	UAUAUCGGAGACAGUGAUCUCCAUAUG	(((((.(((((......))))))))))
mmrnascfg.5.2.tab	GGUCGCGUCAACAGUGUUUGAUCGAAC	........(....).(((((..)))))
mmrnascfg.5.3.tab	UUUCCUGGUUCAACAGUGCUUGGACGGAAC	..........(....)..............
mmrnascfg.5.4.tab	UGUCUUGCUUCAACAGUGUUUGAACGGAAC	.......((.....)).(((((..).))))
mmrnascfg.5.5.tab	UAUCUUGCUUCAACAGUGUUUGGACGGAAC	.......((.....))..............
mmrnascfg.5.6.tab	GUACUUGCUUCAACAGUGUUUGAACGGAAC	.......((.....)).(((((..).))))
mmrnascfg.5.7.tab	UCAUGGUGGUGGCUGGGGCCAUGGAGGUGGCUCG	((((((............))))))......(..)
mmrnascfg.5.8.tab	CAGCACUCGGGGAGCUGUAACCCAGUGCGGUAGCUAU	..............(((.....)))............
mmrnascfg.5.9.tab	UAGCGAACUGGGGGCUGUCACUCAGGGGCGGUAGCGUG	..............(((.....))).............
mmrnascfg.5.10.tab	UAGCAGGCUGGAGGCUGUAAUCCACGGUCGGUAGCGUG	((((..))))............((((........))))
mmrnascfg.5.11.tab	UAGCGCAUUGGUAGCUACGAACCAAGGGCGGUAGCGUG	...(((.(((((........)))))..)))........
mmrnascfg.5.12.tab	CAGCGCUUUGAUAGCUGUGAGUCAAGGGCGGUAGCGUU	...(((((((((........))))).))))........
mmrnascfg.5.13.tab	AAGCGUAUUGGUAGCAGGAAGCCAAGGGCGGUAGCGUU	.....................((..))...........
mmrnascfg.5.14.tab	UAGUGCUCUGGUAGCUGCAAGGCCAGGGGCGGUAGCGUG	...((((((((...........)))).))))........
mmrnascfg.5.15.tab	CAGUAUUCAGGUAGCUGUUGAGCCUGGGGCGGUAGCGUG	......((((((.........))))))............
mmrnascfg.5.16.tab	CGGUGGUGGAGGCUGGGGACAGCCCCACGGUGGAGGCUGG	((...........(((((....)))))))...........
mmrnascfg.5.17.tab	CCAUGGUGGCGGAGGCUGGGGACAGCCCUAUGGUGGCAAG	((((((.....................))))))...(..)
mmrnascfg.5.18.tab	GGGUGGUGGUGGCUGGGGGCAGCCCCAUGGUGGCAGCUGG	(((....................)))..............
mmrnascfg.5.19.tab	UCAUGGAGGUGGCUGGGGUCAGCUCCAUGGUGGUGGCUGG	((((((..............(..)))))))..........
mmrnascfg.5.20.tab	CCAUGGAGGUGGCUGGGGCCAACCUCAUGGAGGAGGCUGG	((((((..................))))))..........
mmrnascfg.5.21.tab	CCAUGGUGGUGGCUGGGGACAACCUCAUGGUGGUGGCUGG	((((((..................))))))..........
mmrnascfg.5.22.tab	UCAUGGUGGUGGCUGGGGGCAACCUCAUGGUGGCGGCUGG	((((((..................))))))..........
mmrnascfg.5.23.tab	CCAAGAUGUGGAGGCUGGGGUCAGCCCUUGGUGGAGGUUGC	(((((.....................)))))..........
mmrnascfg.5.24.tab	CCACAGCGGGGGGACCUGGGGUCAGCCCCAUGGAGGUAGCUGG	...(((.........(((((((..))))))........)))).
mmrnascfg.5.25.tab	CCAUGGUGGCGGUGGCUGGGGACAACCCCAUGGUGGUGGUGGC	((((((.....................))))))..........
mmrnascfg.5.26.tab	CCAUGGUGGUGGCUGGGGACAGCCACGUGGUGGUGGAGGCUGG	........(((((((....))))))).................
mmrnascfg.5.27.tab	CCAGGGAUUUCAUCCCUGGCUAAUAUAUUUCGUGCUUUCAGCACU	((((((((...))))))))............(((((...))))).
mmrnascfg.5.28.tab	ACCCCGGCCCUUCUCAGGGCCACACACAUAUCCCAGAAAGAUCUA	.....((((((....))))))........(((.......)))...
mmrnascfg.5.29.tab	AACCCGGUGUUCUUAAACACCAAUAUUUUCCUUGAUCAUCUCUGG	.....((((((....))))))..............(((....)))
mmrnascfg.5.30.tab	CGGCGGGGACGACUCCGCCGCCCGAACAUCCACGGGGACGACCCC	((((((((....)))))))).............((((....))))
mmrnascfg.5.31.tab	CAAACGGCCCUUUUCAGGGCCACCAAUUGUGUUGAAAAGAACUUAU	(((..((((((....)))))).....))).................
mmrnascfg.5.32.tab	AUCGUUCAUCCCAAUGGGACGCAAGUAAGCCGACUCGGAACGGAUU	.((((((.((((...)))).((......)).......))))))...
mmrnascfg.5.33.tab	ACACUGGAUUUUAUAAAAUCCACUCAUCAAUCAAAGAACUUCUUAU	....((((((((..))))))))........................
mmrnascfg.5.34.tab	CCCAGCAGUGAACUGCUGGGCUACUAUCAGAUGUCCCUUCGGGACA	(((((((((..)))))))))...........((((((...))))))
mmrnascfg.5.35.tab	AAAACGGCCCUUUUCAGGGCCACUAGAGCAUUCCCUAAAAGAGUUG	.....((((((....))))))..............(((.....)))
mmrnascfg.5.36.tab	AUCAGGGCUUCACUUGAAGCCGUCUAAUGUAUCUAAUGUUUUUUAC	.....(((((((..))))))).........................
mmrnascfg.5.37.tab	UAAUUGGAUUUUUUGAAAUCCACCUGCAGUAGGAUAAAGGAGAUGU	....(((((((....)))))))........................
mmrnascfg.5.38.tab	CCUAGCACUGCCGUGCCAGGCUGAGUUAUGGCGUGCUUUCAGCACU	(((.((((....)))).)))............(((((...))))).
mmrnascfg.5.39.tab	CCUAGCUCUCACGAGCCAGGCUGAACUAUAACGUACCUUCGGUACU	(((.((((....)))).)))............(((((...))))).
mmrnascfg.5.40.tab	CCUAGCUCUCACAAGCUAGGCUGUGUUAUGUCGUACCUUUGGUACU	(((((((......)))))))............(((((...))))).
mmrnascfg.5.41.tab	CCUAGUUCUGACGAACCAGGCUCAGUUAUGCCGUGCUUUCAGCACG	(((.((((....)))).)))...........((((((...))))))
mmrnascfg.5.42.tab	CGUGUGGCUCACGCCACACGCUACAUUAUGUCGGGCUUCCAGCCCU	((((((((....))))))))............(((((...))))).
mmrnascfg.5.43.tab	AAACCGGUGUUCUUAAACACCAACUAGCCAAAGAUCAUCUCUCAAA	.....((((((....)))))).........................
mmrnascfg.5.44.tab	UAAUCGGUCCUUUUCAGGACCAAAAACCAGAUUCAAUGAGAUAAAA	.....((((((....))))))..........(((.....))....)
mmrnascfg.5.45.tab	CCAUGGUGGUGGAGGCUGGGGUCAGCCCCAUGGUGGUGGAGGCUGG	((((((.....................)))))).............
mmrnascfg.5.46.tab	CCAUGGUGGUGGAGGAUGGGGUCAGCCUCAUGGUGGUGGCGGUUGG	((((((.....................)))))).............
mmrnascfg.5.47.tab	CCAUGGCGGCGGAGGCUGGGGUCAGCCCCACGGGGGUGGAGGCUGG	((.....))............((((((((.....))....))))))
mmrnascfg.5.48.tab	CCAGGGAGGCGGAGGCUGGGGUCAGCCCCAUGGGGGUGGAGGCUGG	((((.......................((...........))))))
mmrnascfg.5.49.tab	CCCACCGCUUACGCGGUGGGCUAUUUCAUUCCGUCGCUGCGCGACU	((((((((....))))))))............(((((...))))).
mmrnascfg.5.50.tab	CCCACCUCUUACGAGGUGGGCUAUUUUCUUGCGUGCCUUCGGGACU	((((((((....))))))))..........................
mmrnascfg.5.51.tab	CCCACCGCUUACGCGGUGGGCUAUUACGUGGCGUCGCUUCGCGACU	((((((((....))))))))............(((((...))))).
mmrnascfg.5.52.tab	CUCGCUUCGGAAGUGGUGGGCUAUUGCAUCGCGUGCCUUCGGCACU	.......(((...........(.....)))).(((((...))))).
mmrnascfg.5.53.tab	AUCGUUCAGUCCCAUAAGGGACCGCAAGUAAGCCGACACGGAACGGA	..(((((.(((((....))))).((......)).......)))))..
mmrnascfg.5.54.tab	AUCGUUCAUCCUAAAGGACGGAAGUAGGCUAGCCGAAGGAACGCACU	..(((((.((((..))))........(((..)))....)))))....
mmrnascfg.5.55.tab	GUCGUUCAUCCAUAAGGACGGAAGUAGGGAAACCGAAGGAACGCAUC	..(((((.(((....)))(((...........)))...)))))....
mmrnascfg.5.56.tab	UUUGCAGGACGACCUGCAAACGCCUCUUUUCACCGGGGAUGGCCCCA	((((((((....))))))))...................(((..)))
mmrnascfg.5.57.tab	GCCGCGGGACGACCCGUGGCCGAUACGCAACCGGCAGGACGACCUGC	((((((((....)))))))).............(((((....)))))
mmrnascfg.5.58.tab	AACCACGGACGGCCGUGGCACUGAUGAAUAAAGGCGGGACGGCCCGC	..((((((....))))))...............(((((....)))))
mmrnascfg.5.59.tab	AAGUGAGGACGACCUCACCGCUCUUAUCACUAUCGGGGACGACCCCA	..((((((....))))))................((((....)))).
mmrnascfg.5.60.tab	UACGUUCAUCCUACGGGACGGAAGUAGCACUAAGCGAAGGAACGCACU	..(((((.(((........)))(((...)))........)))))....
mmrnascfg.5.61.tab	UACGUUCAUCCCACAGGGACGGAAGUAGCGAAAGCGAAGGAACGCACU	..(((((.((((...))))....................)))))....
mmrnascfg.5.62.tab	UUCGUUCAGGCACUGGCCCGGAAGUAGCAUACAGCGAAGGAACGCACC	..(((((.(((....)))........((.....))....)))))....
mmrnascfg.5.63.tab	UGAUGCACGCAACGGCUUCCUGACGCGUGAGAUUAAAUUAUUGGAGCA	.....(((((..............)))))...................
mmrnascfg.5.64.tab	UACGUUCAUCCCACUGGGACGGAAGUAGCACAAGCGAAGGAACGCACU	..(((((.((((...))))........((....))....)))))....
mmrnascfg.5.65.tab	UCCCCGUCACAACGGCUUCCUGGCGUGGCGGAUGACCCUAAUGGAGCG	...((((....))))........(((((........)).......)))
mmrnascfg.5.66.tab	UAAGGCUUACAACGGCUACCUGAAGUAAGUUGACAUAAAAACGGAGCA	.....(((((..............))))).((..............))
mmrnascfg.5.67.tab	UGCCAGGACAUUCUGCAGAGAAUGUCAAAGAUGCAAUUGGAAUCCUCA	(((...(((((((......)))))))......)))..(((.....)))
mmrnascfg.5.68.tab	UGCCAGGACAUACUACAGAGGAUGUCAAAAAUGCAAUUGGAAUCCUCA	(((...(((((..........)))))......)))..(((.....)))
mmrnascfg.5.69.tab	UACCAGGACAUUCUACAGAGGAUGUCAAAAAUGCAAUUGGAGUCCUCA	..((..((((((((....))))))))............))........
mmrnascfg.5.70.tab	UUCCAGGACAUAAUGGUGAGGAUGUCAAGAAUGCAAUUGGCGUCCUCA	..(((........)))((((((((((((........))))))))))))
mmrnascfg.5.71.tab	AGCAACGGACGACCGUUGCGUAGAUAGAUCAAUAGCGGGACGGCCCGC	.(((((((....)))))))...............(((((....)))))
mmrnascfg.5.72.tab	CGUCGGGGACGACCCCGGCGCUCAUCGAAAAACUGCGGGACGGCCCGC	((((((((....))))))))..............(((((....)))))
mmrnascfg.5.73.tab	CCAAGAGGACGACCUCCCAAUCACCCAAAUGACGCAGGGACGACCCUG	.((.((((....)))).............))...(((((....)))))
mmrnascfg.5.74.tab	UUUCAGGACAUACUGGUGAGGAUGUCAAAAGUGCAAUUGGCGUCCUCA	..((((......))))((((((((((((........))))))))))))
mmrnascfg.5.75.tab	UGCCAGGACAUUCUGGAGAGGAUGUCAAAAAUGCAAUUGGAAUCCUCA	..((((((..)))))).((((((..................)))))).
mmrnascfg.5.76.tab	AUCUCGCCACAACGGCUUCCUGACGUGGCGGCAGAACCCUAAUGGAGCA	...(((((((..............)))))))..................
mmrnascfg.5.77.tab	GCGACCCCACAACGGCUUCCUGGCGUGGGGACACACACAUAAUGGAGCA	....((((((..............))))))...................
mmrnascfg.5.78.tab	UACGUUCAUCCUCGCAAGAGGACGCAAAAGCCGACUGAAGGAACGGAUG	..(((((.(((((....))))).((....)).........)))))....
mmrnascfg.5.79.tab	UUCGUUCAUCUCCUACGGGAGACGCAAAAGCCGACUGAAGGAACGGGAA	.((((((.((((((..)))))).((....)).........))))))...
mmrnascfg.5.80.tab	AGAGCAUCACAACGGCUUCCUGACGUGGUGCGUAAUUUUUAUUGGAGCA	...(((((((..............)))))))..................
mmrnascfg.5.81.tab	ACUCGUCCGCAACGGCUUCCUGACGCGGAUCGACAUUUAAACUGGAGCA	.....(((((..............)))))....................
mmrnascfg.5.82.tab	AGGCGGGGACGACCCCGCUGGAGGUGUUUUUCAGGCGGGGACGACCCCG	..((((((....)))))).................(((((....)))))
mmrnascfg.5.83.tab	AUCGUUCAUCCUCUUAAAGAGGACGCAAGUAAGCCGACUCGGAACGGAAU	.((((((.((((((...)))))).((......)).......))))))...
mmrnascfg.5.84.tab	AUCGUUCAUCCAUUACGGACGGAAGUAGGCAACAGCUGAAGGAACGCGCU	.((((((.........)))))).....(((.................)))
mmrnascfg.5.85.tab	AUGCCGCCCCAACGGCUUCCUGACGGGGCGGAUUCACUUUAAAUGGAGCA	...(((((((..............)))))))...................
mmrnascfg.5.86.tab	CAACCGUCACAACGGCUUCCUGGCGUGACGGGGUUAACCCCAACGGAGCA	...((((....))))..........((..(((((..))))).......))
mmrnascfg.5.87.tab	GCCGGGGGACGACCCCACGGCCGGGACGAUCGCCCGCGAGGACGGCCUCG	.((((.........((..))))))............(((((....)))))
