mmrnascfg.4.1.tab	UAUAUCGGAGGCAGUGACCUCCAUAUG	(((((.(((((......))))))))))
mmrnascfg.4.2.tab	UCUCCUGCUUCAACAGUGCUUGGACGGAGC	....(((......))).(((.......)))
mmrnascfg.4.3.tab	UCUCUUGUUUCAACAGUGUUUGGACGGAAC	....(((((..))))).(((.......)))
mmrnascfg.4.4.tab	GUUCCUGCUUCAACAGUGUUUGGAUGGAAC	(((((....................)))))
mmrnascfg.4.5.tab	GUUCUUGUUUCAACAGUGAUUGAACGGAAC	(((((...(((((......))))).)))))
mmrnascfg.4.6.tab	UUUCCUGCUUCAGCAGUGCUUGGACGGAAC	....(((((..)))))..............
mmrnascfg.4.7.tab	GAGCAUAUUGGAAGCUGUAAUCCAGGGGCGGUAGCGUA	.......(((((........))))).............
mmrnascfg.4.8.tab	CAGUGCAUUGGCUACUGUAAGCCAAGGGCGGUAGCAUG	(..(((.((((((......))))))........))).)
mmrnascfg.4.9.tab	CAGUACAUUGGUAGCUGUAAGCCAAGGGCGGUAGCGUG	(((((..).....)))).....((............))
mmrnascfg.4.10.tab	CAGUGUAUUGGUAGCUGUGAGCCAAGGGCGGUAGCGUG	(......(((((........)))))............)
mmrnascfg.4.11.tab	CAGCAGACUGGAGGCUGUAAUUCAGGUGCGGUAGCUAU	((((.........)))).....................
mmrnascfg.4.12.tab	CAGCAUAUUGGGAGCUGCAACCUAAGGGCGGUAGCGUG	((((.........)))).....................
mmrnascfg.4.13.tab	AAGCACAGCGGCAGCAAAUAAGCCGCGGGCGGUGGUGUC	...(((.(((((.........)))))........)))..
mmrnascfg.4.14.tab	UAGUGCACUGGUAGCUAUUGAGCCAGGGGCGGUAGCAUU	..((((.(((((.........)))))........)))).
mmrnascfg.4.15.tab	UCCUAGAGGAGGCUGGGGGCAGCGUGAAGGAGGAGGCUGG	.(((.......................)))..........
mmrnascfg.4.16.tab	CCAUGGCGGCGGCUGGGGGCAGCCUCACGGUGGUGGCUGG	(((....((.(((((....)))))))...........)))
mmrnascfg.4.17.tab	CCAUGGUGGUGGCUGGGGUCAGCCGCACGGUGGUGGUUGG	(((..........)))..((((((((......))))))))
mmrnascfg.4.18.tab	CCAGGGCGGCGGCUGGGGACAACCCCAUGGGGGUGGCUGG	((((.........(((((....))))).........))))
mmrnascfg.4.19.tab	UCACGGUGGUGGUUGGGGUCAGCCCCAUGGCGGCGGCUGG	.(...............)((((((..........))))))
mmrnascfg.4.20.tab	CCAUGGUGGUAGUUGGGGACAGCCCCACGGUGGUGGCUGG	(((..........(((((....)))))..........)))
mmrnascfg.4.21.tab	CCAUGGGGGCGGCUGGGGACAGCCCCACGGGGGUGGCUGG	(((..........(((((....)))))..........)))
mmrnascfg.4.22.tab	GGGUGGUGGCGGCUGGGGCCAGCCCCACGGGGGUGGCUGG	..................((((((..........))))))
mmrnascfg.4.23.tab	CCAUGGUGGCGGCUGGGGACAGCCCCAUGGUGGCGGAUGG	(((..........(((((....)))))..........)))
mmrnascfg.4.24.tab	CCAUGGUGGUGGCUGGGGACAGCCACAUGGUGGUGGAGGG	((......(((((((....)))))))............))
mmrnascfg.4.25.tab	UGAGAGACAUGGCCUGGGGUCAGCCCCAUGGUAAUGGUGGG	.........(((((...)))))..((((.........))))
mmrnascfg.4.26.tab	GCAUGGUGGUGGUUGGGGACAGCCCCAUGGUGGUGGAGGCUGG	((...................)).(((.............)))
mmrnascfg.4.27.tab	UGGUGGUGGUGGCUGGGGACAGCCCCAUGGUGGUGGUGGCUGG	...........((((....)))).(((.............)))
mmrnascfg.4.28.tab	CGGCGGUGGAGGCUGGGGACAGCCCCAUGGUGGUGGCGGCUGG	.(((.................)))(((.............)))
mmrnascfg.4.29.tab	CCAGGGAGGGGGAGGCUGGGGCCAGCCCCACGGUGGUGGCUGG	((((............((((((..)))))).........))))
mmrnascfg.4.30.tab	CCACGGUGGUGGCUGGGGACAGCCCCAUGGUGGGGGUGGCUGG	(((..........(((((....))))).............)))
mmrnascfg.4.31.tab	UGUUUAGGACGACCUAAGCAGGCUCUCAAUGCGGGACGACCCGC	((((((((....))))))))..........(((((....)))))
mmrnascfg.4.32.tab	GUUACAGGACGACCUGUAAACGCUAUUCUCACCGGGGACGGCCCC	.(((((((....)))))))..............((((....))))
mmrnascfg.4.33.tab	UAAACGGGACGACCUGUUUACGCAUCUGUAUCCGGGGACGACCCC	((((((((....)))))))).............((((....))))
mmrnascfg.4.34.tab	CAAACGGUCCUUUUCAGGACCACAAUACAUUACUCAAGAGCUGUGU	.....((((((....)))))).........................
mmrnascfg.4.35.tab	UUUGAGGCUUCACUAGAAGCCAUUACUAGAUACUUACAAACAAUGU	.....((((((....)))))).........................
mmrnascfg.4.36.tab	CCUAGGGCUUACGCCCUAGGCUAUUAAAGUACGCACCUACAGCGCU	((((((((....))))))))..........................
mmrnascfg.4.37.tab	CAGUGGGCUGAAGCCCACUGCUAUUAUAUUCCGCCGCUGCGCGGCU	(((((((((..)))))))))............(((((...))))).
mmrnascfg.4.38.tab	CCCAGCGUUGAAACGCUGGGCUAUUCUCGGGUGUCCCUACGGGACG	(((((((((..)))))))))...........((((((...))))))
mmrnascfg.4.39.tab	CAAACGGCCCUUUUCAGGGCCACCAAACACACUCAUCAAGGAGUUG	.....((((((....))))))...............((......))
mmrnascfg.4.40.tab	GUUACAGGUAUAUUUAUCCCUACUAAAAAAUGAUUUAAGUUUGAAA	....(..)......................................
mmrnascfg.4.41.tab	CCUAGCUCUCACGAGCUAGGCUAAUUUAUGCCGUUCCUUCAGAACU	((((((((....))))))))....................((..))
mmrnascfg.4.42.tab	CCUAGCACUUGCGUGCCAGGCUGAGUUAUGCCGUGCUUUCAGCACU	(((.((((....)))).)))............(((((...))))).
mmrnascfg.4.43.tab	CCUAGCUCUGGCGAGCCAGGCUAAGUUAUGUCGUGCUUUCAGCACU	(((.((((....)))).)))............(((((...))))).
mmrnascfg.4.44.tab	CCUAGCUCUCACGAGCUAGGCUAAUUUAUACCGUGCUUUCAGCACU	((((((((....))))))))............(((((...))))).
mmrnascfg.4.45.tab	CCUAGUUCUGACGAACUAGGCUGAUCUAUACCGUUCCUUCAGAACU	((((((((....))))))))....................((..))
mmrnascfg.4.46.tab	ACCCCGGCCCUUUUCAGGGCCACCCAAAUGUCUAAGAAAGAGCUGU	.....((((((....)))))).........................
mmrnascfg.4.47.tab	CUAAAGGCCCUUUUCAGGGCCAUCCAAUUAAUCCUCCAAAGGGUUG	.....((((((....)))))).......(((((((....)))))))
mmrnascfg.4.48.tab	ACAACGGCUCUUUUAAGAGCCACCACAUGUGACCGAAAGAGCAUUU	.....(((((((..))))))).............(((......)))
mmrnascfg.4.49.tab	CCCAGCGCUCACGCGCUGGGCUACCAACUGGCGCCACUACGUGGCU	((((((((....))))))))............(((((...))))).
mmrnascfg.4.50.tab	CCCACCGCUUACGCGGUGGGCCAUUGCAUGGCGUCGCUGCGCGACU	((((((((....))))))))............(((((...))))).
mmrnascfg.4.51.tab	CCCUCCACUCACGUGGCGGGCUAUUUCAUUGCGUCGCUACGCGACU	(((.((((....)))).)))............(((((...))))).
mmrnascfg.4.52.tab	CCAACGGCCCUCUUUAGGGCCACAAAUGAUAAAUCCAAACAGUCCG	.....((((((....))))))..................(.....)
mmrnascfg.4.53.tab	CCAACGGCCCUCUUUAGGGCCACAAAUGUGAUAAUAUCCCAUGUAA	.....((((((....)))))).........................
mmrnascfg.4.54.tab	AUCGUUCAACCCAAAAGGGUCGCAAGUAAGCCGACACGGAACGGAUA	.((((((...........((((.........))))...))))))...
mmrnascfg.4.55.tab	UCCUAGCUGCAACGGCUUCCUGGCGCAGCUUACAUUUUAUUGGAGCA	.....(((((..............)))))..................
mmrnascfg.4.56.tab	AAAUGAGGACGACCUCAUCCCUCGCGCUUUUCUCUGGGACGACCCAG	..((((((....))))))...............(((((....)))))
mmrnascfg.4.57.tab	UACGUUCAUCCCUAUGGGACGGAAGUAAGGAAACUGAAGGAACGCACC	..........(((..............)))........((......))
mmrnascfg.4.58.tab	UUCCAGGACAUACUAAUGAGGAUGUCAAAAUUGCAGUUGGGGUCCUCA	.(((((..............................))))).......
mmrnascfg.4.59.tab	UUCCAGGACAUACUGACAAGGAUGUCAAAAAUGCAAUUGGGGUCCUCA	.(((((..............................))))).......
mmrnascfg.4.60.tab	CGCGAUGGACGACCAUCAUGCGGAUCGCAUUUUGGCGGGACGACCUGC	((.(((((....)))))........)).......(((((....)))))
mmrnascfg.4.61.tab	UUCCAGGACAUACUGAUGAGGAUGUCAAAAUUGCAAUUGGGGUACUCA	.(((((..............................))))).......
mmrnascfg.4.62.tab	UUCCAGGACAUAAUGAAGAGGAUGUCAAAAAUGCAAUUGGGGUCCUCA	.(((((..............................))))).......
mmrnascfg.4.63.tab	UUCCAGGACCUACUAGUAAGGAUGUCAAAAAUGCAAUUGGAAUCCUCA	..((((..............................))))........
mmrnascfg.4.64.tab	UUCCAGGACAUACUGCUGAGGAUGUCAAAAAUGCAGUUGGAGUCCUCA	((((((..............................))))))......
mmrnascfg.4.65.tab	UACGUUCAGGCAUCAGCCCGGAAGUAGGAGUUAUCCGAAGGAACGCACC	..(((((.(((....)))((((...........))))...)))))....
mmrnascfg.4.66.tab	CUCCUGUCACAACGGCUUCCUGGCGUGGCGGGCAACAUCCAAUGGAGCA	..((((((((..............)))))))).................
mmrnascfg.4.67.tab	AUCGUUCAGCCAUGAUGGCCGGAAGUAGGUAAUACCGAAGGAACGCACC	..(((((.((((...))))........(((...)))....)))))....
mmrnascfg.4.68.tab	AUCGUUCAUCUCAUAUACGAGACGCAAAAGUUCGCUGAAGGAACGGCAU	.((((((.((((......))))..................))))))...
mmrnascfg.4.69.tab	AACGUUCACCCGAAAGGGCGGAAGUAAGCAAUAGCUGAAGGAACGCACC	.........(((......)))..................((......))
mmrnascfg.4.70.tab	GAAUUGCUACAACGGCUUCCUGACGUGGCGAUCUAUAUGAACUGGAGCA	....((((((..............))))))...................
mmrnascfg.4.71.tab	GUUCUGUCACAACGGCUUCCUGGCGUGACAGGUUUUUCAUAUCGGAGCA	..((((((((..............)))))))).................
mmrnascfg.4.72.tab	UGUCCCCCUCAACGGCUUCCUGACGAGGCGGGCUUAACAAAACGGAGCA	....(((.(((.........)))......))).................
mmrnascfg.4.73.tab	CCCCUAGGACGACCUAGAGGGUGACUUCACCGAUGAUGGGACGACCCAA	...(((((....)))))..(((((..))))).....((((....)))).
mmrnascfg.4.74.tab	AUGCCGCCACAACGGCUUCCUGGCGUGGCGGAUCUCAUCCAAUGGAGCA	...(((((((..............)))))))..................
mmrnascfg.4.75.tab	GAAGCGGGACGACCCGUUUUCCCUCUUUCAUUGCGCGGGGACGACCCUG	....((((....))))...................(((((....)))))
mmrnascfg.4.76.tab	UGACCGCCACAACGGCUUCCUGGCGUGGCGGCGUCAUUUCAACGGAGCA	...(((((((..............)))))))..................
mmrnascfg.4.77.tab	GCUUAGGGACGACCCUAAACAUGCCUUAAUUUGGUAGGGGACGACCCCU	..((((((....)))))).................(((((....)))))
mmrnascfg.4.78.tab	CCGACGCUGCAACGGCUUCCUGGCGCAGCGGUCGCUAUUCAAUGGAGCA	....((((((..............))))))...................
mmrnascfg.4.79.tab	AUCGUUCAACCCAUAUGGGUCGGAAGUAAGCAUCGCUGAAGGAACGCGCA	..(((((.(((((..)))))........(((...)))....)))))....
mmrnascfg.4.80.tab	UACGUUCAACCUUAUGGUCGGAAGUAAGCUUGUAGCUGAAGGAACGCGAU	.........((((.............((((...)))).))))........
mmrnascfg.4.81.tab	UACGUUCAACCUUAUGGUCGGAAGUAAGCUUGUAGCUGAAGGAACGCAAA	.........((((.............((((...)))).))))........
mmrnascfg.4.82.tab	AUCGUUUAUCCUAUACGGACGGAAGUAGGCAUUUGCCGAAGAAACGCACC	..(((((.(((.........)))....((((..))))....)))))....
mmrnascfg.4.83.tab	AUCGUUCAUCCUAAAAGGACGGAAGUAAGCAUCAGCUGAAGGAACGCACC	..(((((.((((...))))........(((....)))....)))))....
mmrnascfg.4.84.tab	AACGUUCAACCUUAUGGUCGGAAGUAAGCUUGUAGCUGAAGGAACGUAUU	.........((((.............((((...)))).))))........
mmrnascfg.4.85.tab	UACCUGCCACAACGGCUUCCUGGCGUGGCGGGCUGAACCUCAAUGGAGCA	..((((((((..............))))))))..................
mmrnascfg.4.86.tab	GCGCGAGGACGACCUCGGCCAAAUCGGCGACAGCAUGCGGGACGGCCCGG	...(((((....)))))......((((...................))))
mmrnascfg.4.87.tab	AGGCCGGGACGACCCGGCCAUUCCCUCGGGACCCGGCCGGGACGACCCGG	.(((((((....)))))))......(((((...............)))))
