mmrnascfg.2.1.tab	AUUAUCGGGAGCAGUGUCUUCCAUAAU	(((((.(((((......))))))))))
mmrnascfg.2.2.tab	AUUAUCGGGGACAGUGUUUCCCAUAAU	(((((.(((((......))))))))))
mmrnascfg.2.3.tab	UUUCUUCUUCAACAGUGUUUGGAUGGAAC	......((.....)).(((.......)))
mmrnascfg.2.4.tab	AUUCUUGCUUCAACAGUGUUUGAACGGAAU	(((((...(((((......))))).)))))
mmrnascfg.2.5.tab	GUUCCUGCUUCAACAGUGCUUGGACGGAAC	(((((...(((((......))))).)))))
mmrnascfg.2.6.tab	UUUCCUGCUUCAACAGUGCUUGGAUGGAAC	....(((.(((((......))))))))...
mmrnascfg.2.7.tab	GUUCUUGCUUCAACAGUGAUUGAACGGAGC	(((((...(((((......))))).)))))
mmrnascfg.2.8.tab	CCAUGGCGGUGGCUGGGGCCAUGGAGGUGGCUCG	(((((((..........)))))))..........
mmrnascfg.2.9.tab	CAGCGCAUUGGUUGCUGUAAGCCAAGGGCGGUAGCAUA	(((((.(....)))))).....................
mmrnascfg.2.10.tab	AAGCACAUGAGGAGCUAUAACCUUAGGGCGGUAGCAUU	..((.........)).......................
mmrnascfg.2.11.tab	AAGCACUUUGGGAGCUUUAACCUAAGGGCGGUAGCGUA	..((.........)).......................
mmrnascfg.2.12.tab	AAAUACCGUGGUGGCUUAAAACCAGGUGCAGCAUCCUG	.....(((...)))........((((........))))
mmrnascfg.2.13.tab	GAGCGCAUUGGAAGCUGUAAUCUAGGGGCGGCAGCGUG	...(((..((((........)))).........)))..
mmrnascfg.2.14.tab	CAGCAAGCUCGAGGCUGGAAUUCAGGGGCGGUAGCGUU	((((.........)))).....................
mmrnascfg.2.15.tab	CAGCACACUGGAGGCUGAAAUUCAGGGGCGGUAGCCAU	((((.........)))).....................
mmrnascfg.2.16.tab	UAGUGCACUGGUAGCUGUUAAGCCAGGGGCGGUAGCUUG	....((.......))...(((((...........)))))
mmrnascfg.2.17.tab	CAGUGUAUUGGUAGCUAAAAAGCCAGGGGCGGUAGCGUG	(...)...((.............(............)))
mmrnascfg.2.18.tab	CCACGGAGGAGGCUGGGGUCAGCCCCACGGAGGCGGCUGG	((..............))((((((..........))))))
mmrnascfg.2.19.tab	UCAUGGUGGUGGCUGGGGCCAGCCCCAUGGUGGUAGCUGG	(((..........((((((..))))))..........)))
mmrnascfg.2.20.tab	CCAUGGCGGUGGCUGGGGACAGCCUCACGGUGGUGGUUGG	(((.......(((((....))))).............)))
mmrnascfg.2.21.tab	AGGUGGUGGUGGCUGGGGACAACCCCACGGUGGUGGCUGG	........................(((..........)))
mmrnascfg.2.22.tab	CCACGGUGGCGGCUGGGGUCAGCCCCACGGUGGCGGCUGG	((..............))((((((..........))))))
mmrnascfg.2.23.tab	CCAUGGUGGCGGUUGGGGGCAACCCCAUGGUGGCAGCUGG	(((..........(((((....)))))..........)))
mmrnascfg.2.24.tab	CCAUGGCGGUGGCUGGGGUCAGCCCCACGGCGGCGGCUGG	(((..........)))..((((((..........))))))
mmrnascfg.2.25.tab	CCACGGAGGUGGCUGGGGUCAGCCCCACGGAGGUGGUUGG	(((..........(((((....)))))..........)))
mmrnascfg.2.26.tab	CCACGGGGGUGGCUGGGGUCAGCCCCACGGGGGUGGCUGG	(((..........(((((....)))))..........)))
mmrnascfg.2.27.tab	CCAGAGCGGUGGCUGGGGGCAGCCUCAUGGUGGUGGCUGG	((((......(((((....)))))............))))
mmrnascfg.2.28.tab	UCAUGGAGUGGCAGGGGACAGCCUGAUGGUGUUGAGGGUUGG	(((......(((........)))................)))
mmrnascfg.2.29.tab	ACAUGGUGGUGGCUGGGGACAGCCCCAUGGCGGCGGUGGCUGG	..........(((((....)))))(((.............)))
mmrnascfg.2.30.tab	CGGUGGGGGCGGCUGGGGCCAGCCUCAUGGUGGGGGCGGCUGG	..................((((((.............))))))
mmrnascfg.2.31.tab	UCACGGUGGCGGCGGAUGGGGCCAGCCCCACGGUGGCGGCGGA	((..............((((((..))))))...........))
mmrnascfg.2.32.tab	UCGAGGACGACCUCAAAAUCACCUUUUCGGCCGGGACGACCCGG	..((((....))))................(((((....)))))
mmrnascfg.2.33.tab	CCAAAGGUGUUUUUUAACACCACACAAAAAACCAAUUUCUUUUCA	.....((((((....))))))........................
mmrnascfg.2.34.tab	UUUUAGGCUUCACUAGAAGCCACCAACGUUUACUUCGGACGUCAU	.....((((((....))))))........................
mmrnascfg.2.35.tab	ACAAAGGCUCUUUUAAGAGCCACAACAAGUCUGUUCAAGGAGCAU	.....(((((((..)))))))........................
mmrnascfg.2.36.tab	ACAAAGGCUCUUUUCAGAGCCACCGACACUUUCUGGGAAUGAGCU	.....((((((....))))))........................
mmrnascfg.2.37.tab	CCUAGGGCUUACGCCCUAGGCUAAUAAGUAGCGCGCCUACAGCGCU	((((((((....)))))))).........(((((.......)))))
mmrnascfg.2.38.tab	UGGCACGCAACGGCUUCCUGACGCGUGAGAUUGAAUUAUUGGAGCA	...(((((..............)))))...................
mmrnascfg.2.39.tab	UAGCACGCAACGGCUUCCUGACGCGUGAGCUUUAAUUAUCGGAGCA	...(((((..............)))))...................
mmrnascfg.2.40.tab	UGACAGGCGUUACUAGACGCCACAAAUAGUUUAUGUUGCUCUUUGG	.....((((((....)))))).........................
mmrnascfg.2.41.tab	AAAACGGCUCUUUUAGGAGCUACCACAUGCAAAAAAGUCAAUAGCC	......((((((..))))))..........................
mmrnascfg.2.42.tab	CCUAGCUCUCACGAGCCAGGCUAUGUUAAGCCGUCCCUUCGGGACU	....((((....))))..((((......))))(((((...))))).
mmrnascfg.2.43.tab	CCUAGUUCUCACGAACUAGGCUUAGUUAUGGCGUGCCUUCAGCACU	((((((((....))))))))............((((.....)))).
mmrnascfg.2.44.tab	CCUAGCACUCCCGUGCUAGGCUAAUGUAUGUCGUGCCUUCAGCACU	((((((((....))))))))............((((.....)))).
mmrnascfg.2.45.tab	CCUAGCACUUUCGUGCCAGGCUGUACUAUAUCGUCCCUUUGGGACU	(((.((((....)))).)))............(((((...))))).
mmrnascfg.2.46.tab	CCUAGCACUUGCGUGCUAGGCUGAGUUAUGUCGUCCCCUUGGGACU	((((((((....))))))))............(((((...))))).
mmrnascfg.2.47.tab	CCCAAGGCUCACGCCCUGGGCUAUUACACGUCGCUCCUUCAGAGCU	((((.(((....))).))))............((((.....)))).
mmrnascfg.2.48.tab	CCCAGGGCUUACGCCCUAGGCUAUUUCACGUCGCCCCUCCGGGGCU	.(((((((....))))).))............(((((...))))).
mmrnascfg.2.49.tab	CCAACGGCCCUCUUUAGGGCCACAAAUAACACGAAUCCUAAAAUAU	.....((((((....)))))).........................
mmrnascfg.2.50.tab	UUUAAGGCUUCACUAGAAGCCAUUAUAUAUAAUAUACACAUAUAUA	.....((((((....)))))).........................
mmrnascfg.2.51.tab	CAAAAGGCCCUUUUCAGGGCCCCCAAACUGUCACAGAAAGAGCUGU	.....((((((....))))))...........((((......))))
mmrnascfg.2.52.tab	GCAGGGUGGCGGCACCUGGGGGCAGCCUCAUGGUGGUGGUGGCUGG	((......................)).(((.............)))
mmrnascfg.2.53.tab	CCUCGGGUUGAAACCCGAGGCUGACAAAUUUCACCGCUCCGCGGUU	(((((((((..)))))))))............(((((...))))).
mmrnascfg.2.54.tab	CCCACCACUCACGUGGUGGGCUAUUUCAUUCCGUCGCUGCGCAACU	((((((((....))))))))..........................
mmrnascfg.2.55.tab	CCCACCACUCACGUGGUGGGCUAUCUCGUUCCGAGCCUGUGGCACU	((((((((....))))))))....((((...))))...........
mmrnascfg.2.56.tab	CGGGAAGGACGGCCUUCCCGCUUCUUCAACGAACGGGACGGCCCGU	((((((((....))))))))............(((((....)))))
mmrnascfg.2.57.tab	CAAACGGCUCUUUUCAGAGCCACCAAAUAAUCAAGAAAGAAUACUG	.....((((((....))))))..........((...........))
mmrnascfg.2.58.tab	UUCGUUCAUCCCGAAAGGGACGCAAAAGCCGACUGAAGGAACGGAAC	.((((((.((((....))))..................))))))...
mmrnascfg.2.59.tab	AACGUUCAUCCCGAAAGGGACGCAAGUAAGCCGACACGGAACGGAUU	..(((((.((((....))))..................)))))....
mmrnascfg.2.60.tab	UACGUUCAUCCCAAAAGGGACGCAAGUAAGCCGACACGGAACGGAAU	..(((((.((((....))))..................)))))....
mmrnascfg.2.61.tab	UUCGUUCAUCCCCUUGGGGACGCAAAUGCCGACUGAAGGAACGGAUA	.((((((.(((((..))))).(((..))).........))))))...
mmrnascfg.2.62.tab	AUCGUUCAUCCCGUAAGGGACGCAAAAGCCGACUGAAGGAACGGGAU	.........(((((..........................)))))..
mmrnascfg.2.63.tab	UGGCUGGGACGACCCAGUUACGCAUCUGUUUUUCGGGGACGGCCCCG	...(((((....)))))................(((((....)))))
mmrnascfg.2.64.tab	AUGUGGGGACGACCUCACCGCUCUAAUUAAUAAUGAGGACGACCUCA	..((((((....))))))...............(((((....)))))
mmrnascfg.2.65.tab	AUCGUUCAUCCCCAAGGGGGACGCAAAUGCCGACUGAAGGAACGGGUC	........(((((..)))))...........(((...........)))
mmrnascfg.2.66.tab	ACAUGUACGCAACGGCUUCCUGGCGCGUGAACCGUAAUUAUUGGAGCA	.....(((((..............)))))...................
mmrnascfg.2.67.tab	AACGUUCAGGCGUCAAGCCCGGAAGUAGCAUUAGCGAAGGAACGCACU	..(((((................................)))))....
mmrnascfg.2.68.tab	AUCGUUGGACUAAAAGUCGGAAGUAAGCAAUCGCUGAAGCAACGCACU	..((((..........................(((..)))))))....
mmrnascfg.2.69.tab	UUCCAGGACAUACUGGUGAGGAUGUCAAAAAUGCAAUUGAGGCCCUCA	..((((......))))(((((...((((........))))...)))))
mmrnascfg.2.70.tab	UUCCAGGACAUACUGGUGAGGAUGUCAAAAAUGCAAUUGGCAUCCCCA	..((((......))))((.(((((((((........))))))))).))
mmrnascfg.2.71.tab	CCGCCGGGACGACCCGGCCAUGUACGGGUAGUUGUCAGGACGACCUGC	..((((((....))))))...(((......((((((..)))))).)))
mmrnascfg.2.72.tab	ACUCCUCCACAACGGCUUCCUGACGUGGGGGAUUAUUUGAAUGGAGCA	...(((((((..............))))))).................
mmrnascfg.2.73.tab	AAGUGAGGACGACCUCACCGCUCCAUCUUUUCUUCGGGGACGACCCCA	..((((((....)))))).................((((....)))).
mmrnascfg.2.74.tab	CACCACGGACGACCGUGGCACAUGACGAAUGACGGCGGGACGGCCCGC	..((((((....))))))................(((((....)))))
mmrnascfg.2.75.tab	UUCCAGGACAUACUGUUGAGGAUGUCAAAAAUGCAAUUGGGGUCCUCA	.(((((..............................))))).......
mmrnascfg.2.76.tab	UUCCAGGACAUACUAAUGAGGAUGUCAAAAAUGCAAUUGGGAUUCUCA	.(((((..............................))))).......
mmrnascfg.2.77.tab	UUCCAGGACAUACUGAUGAGAAUGUCAAAGAUGCAGUUGGGGUCCUCA	.(((((..............................))))).......
mmrnascfg.2.78.tab	UUCCAGGACAUACUGAUGAGGAUGUCAAAAAUGCAAUUGGCGUCCUCG	................((((((((((((........))))))))))))
mmrnascfg.2.79.tab	UUCCAGGACAUACUAAGGAGGAUGUCAAAGAUGCAAUUGGGGUCCUCA	.(((((..............................))))).......
mmrnascfg.2.80.tab	UACGUUCAGGCAUCAGGCCCGGAAGUAGCAUACAGCGAAGGAACGCACC	..(((((.................................)))))....
mmrnascfg.2.81.tab	GUGCUGUCACAACGGCUUCCUGGCGUGGCGGCGAAAACCUAAUGGAGCA	.(((((((((..............)))))))))................
mmrnascfg.2.82.tab	AUCGUUCAACCUCACUAGAGGUCGCAAGUAAGCCGACUCGGAACGGAUA	.((((((.(((((....)))))..................))))))...
mmrnascfg.2.83.tab	ACCCCGUCACAACGGCUUCCUGGCGUGACGGAGAAACCCGAAUGGAGCA	...(((((((..............)))))))..................
mmrnascfg.2.84.tab	UACCUGUCACAACGGCUUCCUGGCGUGACGAGGUGACCUCAGUGGAGCA	((((.(((((..............)))))..))))..............
mmrnascfg.2.85.tab	UUACUGCCACAACGGCUUCCUGGCGUGGCAGGCUAAACCCAACGGAGCA	...(((((((..............)))))))..................
mmrnascfg.2.86.tab	CGGCCGGGACGACCCGGCCGAACAAGGAGCAUGAGCCGGGACGGCCCGG	((((((((....))))))))...............(((((....)))))
mmrnascfg.2.87.tab	GCUUAGGGACGACCCUAAAUACGCCUAAUCUAACAUGGGGACGACCCCU	..((((((....))))))..................((((.....))))
mmrnascfg.2.88.tab	GCGCUGCCACAACGGCUUCCUGGCGUGGCGGUCUGACAGUCAAUGGAGCA	...(((((((..............)))))))...................
mmrnascfg.2.89.tab	CUCGUUCAUCCUAAAAGGACGGAAGUAGGCUUUUGCCGAAGGAACGCACC	..(((((.((((...))))......................)))))....
mmrnascfg.2.90.tab	AUCGUUCAACCAUAUGGUCGGAAGUAGGUUUGACACCGAAGGAACGCAUC	..(((((..........((((..............))))..)))))....
mmrnascfg.2.91.tab	CGACCGGGACGGCCCGGUCGCUUCCCUGGGGCACAGCCGGGACGACCUGG	((((((((....))))))))................(((((....)))))
