mmrnahmm.1.1	UCGUUCGUCCUCAGUGCAGGGCAACAG	(.(((.(((((......))))))))).
mmrnahmm.1.2	UUUAUCAGUGACAGAGUUCACUAUAAA	(((((.((((........)))))))))
mmrnahmm.1.3	UCUUGCUUCAACAGUGUUUGGACGGAAG	............................
mmrnahmm.1.4	UCUCUUGCUUCAACAGUGUUUGGAUGGAAC	..............................
mmrnahmm.1.5	AGUCCUGCUUCAACAGUGCUUGAACGGAAC	..............................
mmrnahmm.1.6	UUACCUGCUUCAACAGUGCUUGAACGGCAA	..............................
mmrnahmm.1.7	GUUGGCGCUUCAACAGUGAUUGAACGGAAC	((((......))))................
mmrnahmm.1.8	CAGUGCAUUGGUUACUGCAAGCCAAGGGCGGUAGCAUU	(((...........))).....................
mmrnahmm.1.9	CAGCGCUUUGGGAGCUGAAACUCAAGGGCGGUAGCGUA	((((.........)))).....................
mmrnahmm.1.10	GGGCAUAUUGGAAGCCGUAAUCCAUGGGCGGUAGCGUG	......................................
mmrnahmm.1.11	GGGCACGUUGGAAGCCAAAAUCCAUGGGCGGUAGCGUG	......................................
mmrnahmm.1.12	GAGCAUAUUGGAAGCUGUAAUCCACGGGCGGCAGCGUG	......................................
mmrnahmm.1.13	UAGCGCAUUGGGAGCUGUAACUCAAGGGCGGUAGCGUG	......................................
mmrnahmm.1.14	CAGUGCACUGGUAGCUGAUGAGCCAGGGGCGGUAGCGUG	((((..)))).............................
mmrnahmm.1.15	CAGUGCUCUGGUAGCUGUAAAGCCAGGGGCGGUAGCGUG	(.((.(((((((.........))))))))))........
mmrnahmm.1.16	CAGUGUACUGGUAGCUGUGGAGCCAGGGGCGGUAGCGUG	(((....))).............................
mmrnahmm.1.17	CCACGGCGGUGGCUGGGGGCAGCCCCACGGUGGUGGCUGG	((((..(.((((............))))))))).......
mmrnahmm.1.18	UCACGGUGGCGGCUGGGGGCAGCCCCAUGGUGGUGGCUGG	...............(((((.)))))..............
mmrnahmm.1.19	UCAUGGUGGCGGCUGGGGGCAACCCCAUGGUGGUGGCACC	((((((..................))))))..........
mmrnahmm.1.20	GGGCGGUGGUGGCUGGGGUCAGCCCCAUGGUGGCGGCUGG	((((.................))))...............
mmrnahmm.1.21	UCAUGGUGGUGGUUGGGGUCAGCCCCAUGGUGGUGGCUGG	((((((..................))))))..........
mmrnahmm.1.22	UCAUGGUGGUGGCUGGGGUCAGCCCCAUGGCGGGGGCUGG	((((((..................))))))..........
mmrnahmm.1.23	GGGCGGUGGUGGCUGGGGGCAGCCUCAUGGUGGUGGCUGG	((((.................))))...............
mmrnahmm.1.24	UCAUGGUGGCGGCUGGGGACAGCCUCAUGGUGGUGGCUGG	((((((....(((((....)))))))))))..........
mmrnahmm.1.25	CUCGCAAGACGACUUGCGAGAUGUAAGCAAUCGGGACGGCCCG	((((((((....)))))))).......................
mmrnahmm.1.26	UCAUGGUGGUGGCUGGGGGCAACCCCAUGGUGGCGGAGGUUGG	((((((..................)))))).............
mmrnahmm.1.27	GGGUGGUGGCGGCUGGGGUCAGCCCCACGGCGGUGGAGGCUGG	(((....................))).................
mmrnahmm.1.28	CCAUGGUGGUGGAGGCUGGGGUCAGCCCCAUGGUGGUGGCACC	((((((.....................))))))..........
mmrnahmm.1.29	UCACAGUGGCGGCUGGGGACAGCCCCAUGGUGGUGGCGGCUGG	..........(((((....)))))...................
mmrnahmm.1.30	UCACGGUGGUGGCUGGGGACAGCCCCACGGUGGUGGUGGCUGG	..........(((((....)))))...................
mmrnahmm.1.31	CCACAGUGGGGGCAACUGGGGCCAGCCCCAUGGUGGUGGUUGG	((((.)))).......((((((..)))))).............
mmrnahmm.1.32	GCAUGGAGGUGGCUGGGGACAGCCACAUGGUGGUGGAGGCUGG	........(((((((....))))))).................
mmrnahmm.1.33	AACUCGGUGUUUCUCAACACCACCUCUUUGCCUUUGGUUGUGCCU	.....((((((....))))))........................
mmrnahmm.1.34	GCCCGGGGACGGCCCCGGGCCGUUCGCUUCAACGGGGACGACCCC	(((((((......))))))).............((((....))))
mmrnahmm.1.35	UUUGCAGGACGACCUGCAAACGCUUCUUUCACCGGGGACGGCCCC	((((((((....)))))))).............(((......)))
mmrnahmm.1.36	AAAACGGCUCUUUUCAGAGCCACCUAUUUAUACAAAGAGAUGAAGU	.....((((((....)))))).........................
mmrnahmm.1.37	AGACACGCAACGGCUUCCUGACGCGUGAAAUUAAAUUAUUGGAGCA	...(((((..............)))))...................
mmrnahmm.1.38	CCUAGGGCUUACGCCCUAGGCUAAUAAAGUUCGCCCCUUCAGGGCU	((((((((....))))))))............((((.....)))).
mmrnahmm.1.39	GAACAGGUGGCACUAGCCACCAUAAAUUUUGAGAUAAAAGUUUUAG	.....((((((....)))))).........................
mmrnahmm.1.40	CCCAGCGAUGAAUCGCUGGGCUAUUGUCCAACGACCCGCCGGGUCG	(((((((((..)))))))))...........(((((((.)))))))
mmrnahmm.1.41	ACCCAGGCUUCACUUGAAGCCAUAAUCAUACACUAAUUUUUUACCA	.....(((((((..))))))).........................
mmrnahmm.1.42	CCUAGCUCUCACGAGCCAGGCUAGCGUAUGCCGUACCUUAGGUACU	(((.((((....)))).)))............(((((...))))).
mmrnahmm.1.43	CCUAGCACUUCCGUGCCAGGUUAAUGUAUGGCGUGCCUUCGGCACU	............(((((.......................))))).
mmrnahmm.1.44	GCUAGUUCUCACGAACUAGGCUAAGUUAUGGCGUGCUUUCAGCACU	((((((((....)))))).))...........(((((...))))).
mmrnahmm.1.45	CCUAGCCCUUACGGGCCAGGCUAAAUUAUGCCGUGCUUUCAGCACU	(((.((((....)))).)))............(((((...))))).
mmrnahmm.1.46	CCUAGUUCUGACGAAUUAGGCUCAGCUAUGCCGUGCUUUCAGCACU	((((((((....))))))))............(((((...))))).
mmrnahmm.1.47	CGUGUGGCUAACGCCACACGCUAAUAUCUAUCGGUGCUCUGCACCU	((((((((....))))))))..........................
mmrnahmm.1.48	CCAACGGCCCUCUUUAGGGCCACGAAUCACAUGAAUCCAAAUUGAU	.....(((((......))))).........................
mmrnahmm.1.49	CAAUCGGUCCUUUUCAGGACCACCAUUCAGUUUUUAAAAGGAGGAA	.....((((((....)))))).........................
mmrnahmm.1.50	CUUUAGGCUUCACUAGAAGCCACCAAAACUAUUUUUCCCGCCAAGU	.....((((((....)))))).........................
mmrnahmm.1.51	CCAAAGGCUCUUUUCAGAGCCACCCACAUGCGCGCUGAAAAGAUCU	.....((((((....)))))).........................
mmrnahmm.1.52	CCAACGGCUCUUUUCAGAGCCACCCACAGAGUCAGAAAAAGUGUCU	.....((((((....)))))).........................
mmrnahmm.1.53	CCCACCACUCUCGUGGUGGGCUUAUUUAUUGCGUCGCUGCGCGACU	((((((((....))))))))............(((((...))))).
mmrnahmm.1.54	CCCACCUCUUACGAGGUGGGCUAUUGCAUUUCGUCGCUUCGCGACU	((((((((....))))))))............(((((...))))).
mmrnahmm.1.55	CCUCGGGGACGACCUCGAGGCCUCCUGAUACGCAGGGACGACCCUG	((((((((....))))))))............(((((....)))))
mmrnahmm.1.56	CCGUGGGAUGAAUCCCACGGCUAACAUCAAGCGCCCCGACGGGGCU	(((((((((..)))))))))............((((((.)))))).
mmrnahmm.1.57	CCAAAGGCUCUUUUCAGAGCCACCUCAGUGUAUCAGAAAAGUGUAA	.....((((((....)))))).........................
mmrnahmm.1.58	GCCCGGGGACGACCCCGGGCCGUCGAUGUUCAACGGGGACGACCCCA	((((((((....)))))))).((((..............))))....
mmrnahmm.1.59	UACGUUCAUCUAUUAUAGACGGAAGUAGCGAAAGCGAAGGAACGCACC	................................................
mmrnahmm.1.60	AAUUGCACGCAACGGCUUCCUGACGCGUGAGUUUUAAUUAUCGGAGCA	((((((((((..............))))).....))))).........
mmrnahmm.1.61	AAUGUUCUACAACGGCUUCCUGACGUAGGGCAAUUCUUUUUUGGAGCA	................................................
mmrnahmm.1.62	AAUCGGCCACAACGGCUUCCUGACGUGGCUAAGAAAUCUAUUGGAGCA	....((((((..............))))))..................
mmrnahmm.1.63	UCCUCUCACAACGGCUUCCUGACGUGACGAGGUUAACCCAAUGGAGCA	.((((((((..............)))).))))................
mmrnahmm.1.64	AUUCUGUCACAACGGCUUCCUGACGUGGCAGAGAUUUUUAAUGGAGCA	((((((((((..............)))))))).)).............
mmrnahmm.1.65	AAUCUGCCACAACGGCUUCCUGACGUGGCUAUUUAAUCUAUUGGAGCA	.....(((((..............)))))...................
mmrnahmm.1.66	GGGCCGGGACGACCCGCCCCUUUUCCCCUCACCUCCGGGACGGCCCGG	((((.(((....)))))))...............((((......))))
mmrnahmm.1.67	UUCCAGGACAUAUUGAUGAGGAUGUCAAAAAUGCAGUUGGGGUCCUCA	................((((........................))))
mmrnahmm.1.68	UGCCAGGACAUUCUGCGGAGGAUGUCAAAAAUGCAAUUGGGAUCCUCA	................................................
mmrnahmm.1.69	UUCCAGGACAUACUAAUGAGGAUGUCAAAAAUGCAAUUGGAGUCCUCA	................(((((((..................)))))))
mmrnahmm.1.70	CGGUGGGGACGACCCCACCCUUCGCAAAGUUUCGCGGGGACGACCCCG	.(((((((....)))))))...............(((((....)))))
mmrnahmm.1.71	UUCCAGGACAUGCUAACGAGGAUGUCAAAAAUGCAAUUGGGGCCCUCA	.....................................(((((.)))))
mmrnahmm.1.72	UUCCAGGACAUACUGGUGAGGAUGUCAAAAAUGCAAUUGGCGUACUCA	................................................
mmrnahmm.1.73	UUCCAGGACAUACUGAUGAGGAUGUCAAAAAUGCAGUUGGGGCCCUCG	................................................
mmrnahmm.1.74	UUCCAGGACAUACUAACGAGGAUGUCAAAAAUGCAAUUGAGAUCCUCA	................................................
mmrnahmm.1.75	AACGUUCACCCGAAAGGGCGGAAGUAGGCGGUCGCUGAAGGAACGCACC	..(((((.(..............................))))))....
mmrnahmm.1.76	AACGUUCACCCGUAAGGGCGGAAGUAAGCGAUCGCUGAAGGAACGCACC	..(((((.(..............................))))))....
mmrnahmm.1.77	AUCGUUGGACUAUUAAGUCGGAAGUAGGCAUAAGCCGAAGCAACGCACC	.................................................
mmrnahmm.1.78	AUCGUUCAUCUCAUCAUUGAGACGCAAGUAAGCCGACUCGGAACGGAAU	.................................................
mmrnahmm.1.79	UUCGUUCAUCCUCGCAAGAGGACGCAAAAGCCGACUGAAGGAACGGGAA	(((((((.(((((....)))))............((..))))))..)))
mmrnahmm.1.80	CAACCGCCACAACGGCUUCCUGACGUGGCGGGGAUAUCAUAACGGAGCA	(..(((((((..............)))))))).................
mmrnahmm.1.81	UCGCUGUCACAACGGCUUCCUGGCGUGGCGGUAAGAUCCCAAUGGAGCG	((((...(((..............)))))))..................
mmrnahmm.1.82	CCAUGGAGGUGGAGGCUGGGGUCAGCAGCCCCAUGGAGGUGGAGGCUGG	((((((........................)))))).............
mmrnahmm.1.83	GCUUAGGGACGACCUUAAAUACGCCGAUAUCAAUUUGGGGACGACCCCG	((((((((....))))))....))............((((....)))).
mmrnahmm.1.84	GGCCGGGGACGACCCUGGCCGCCAGAACGAAAACGGCGGGAGGACCUGG	((((((((....)))))))).............................
mmrnahmm.1.85	AUCGUUCAACCCUUUUGGGUCGGAAGUAGGCAAAGCUGAAGGAACGCGCA	..................................................
mmrnahmm.1.86	UACGUUCAUCAUAUAGACGGAAGUACCCAAUCUUGGGGAAGGAACGCACU	..................................................
mmrnahmm.1.87	AUCGUUCAACCAUUAAGGUCGGAAGUAGGCAAUCGCUGAAGGAACGCACC	..................................................
mmrnahmm.1.88	ACCGUUUAACUCGAAAGAGUCGGAAGUAGGGAAAACCGAAGAAACGCACU	..................................................
mmrnahmm.1.89	AACGUUCAUCCCACUGGGACGGAAGUAAGCAUAAGCUGAAGGAACGCUUC	........(((((.)))))...............................
mmrnahmm.1.90	CACGUUCAUCCUAUUAUAGGACGGAAGUAGCAAUAGCGAAGGAACGCACU	(.(((((...........))))))..........................
mmrnahmm.1.91	AACGUUCAUCCUACGGGACGGAAGUAGGCUUUAUGCUGAAGGAACGCACC	.........(((((.........)))))......................
mmrnahmm.1.92	GCGCGGGGACGACCCCGCGCCUCCCCAAGAAUUCGGUCGGGACGACCCGC	((((((((....))))))))..............(((((...)))))...
mmrnahmm.1.93	AGCGAACCACAACGGCUUCCUGACGUGGUUCUUCAUUGGCGAUUGGAGCG	...(((((((..............)))))))...................
