mmrnahmm.4.1	UAUAUCGGAGGCAGUGACCUCCAUAUG	(((((.(((((......))))))))))
mmrnahmm.4.2	UCUCCUGCUUCAACAGUGCUUGGACGGAGC	......(((((..............)))))
mmrnahmm.4.3	UCUCUUGUUUCAACAGUGUUUGGACGGAAC	......(((((..............)))))
mmrnahmm.4.4	GUUCCUGCUUCAACAGUGUUUGGAUGGAAC	(((((....................)))))
mmrnahmm.4.5	GUUCUUGUUUCAACAGUGAUUGAACGGAAC	(((((....................)))))
mmrnahmm.4.6	UUUCCUGCUUCAGCAGUGCUUGGACGGAAC	....(((((..)))))..............
mmrnahmm.4.7	GAGCAUAUUGGAAGCUGUAAUCCAGGGGCGGUAGCGUA	......................................
mmrnahmm.4.8	CAGUGCAUUGGCUACUGUAAGCCAAGGGCGGUAGCAUG	(((((.......))))).....................
mmrnahmm.4.9	CAGUACAUUGGUAGCUGUAAGCCAAGGGCGGUAGCGUG	......................................
mmrnahmm.4.10	CAGUGUAUUGGUAGCUGUGAGCCAAGGGCGGUAGCGUG	......................................
mmrnahmm.4.11	CAGCAGACUGGAGGCUGUAAUUCAGGUGCGGUAGCUAU	(((....)))............................
mmrnahmm.4.12	CAGCAUAUUGGGAGCUGCAACCUAAGGGCGGUAGCGUG	((((.........)))).....................
mmrnahmm.4.13	AAGCACAGCGGCAGCAAAUAAGCCGCGGGCGGUGGUGUC	.......(((((.........))))).............
mmrnahmm.4.14	UAGUGCACUGGUAGCUAUUGAGCCAGGGGCGGUAGCAUU	.......................................
mmrnahmm.4.15	UCCUAGAGGAGGCUGGGGGCAGCGUGAAGGAGGAGGCUGG	((((.......................)))).........
mmrnahmm.4.16	CCAUGGCGGCGGCUGGGGGCAGCCUCACGGUGGUGGCUGG	(((..................................)))
mmrnahmm.4.17	CCAUGGUGGUGGCUGGGGUCAGCCGCACGGUGGUGGUUGG	((...((.(((((((....)))))))))))..........
mmrnahmm.4.18	CCAGGGCGGCGGCUGGGGACAACCCCAUGGGGGUGGCUGG	.............(((((....))))).............
mmrnahmm.4.19	UCACGGUGGUGGUUGGGGUCAGCCCCAUGGCGGCGGCUGG	...................(((((((.....)).))))).
mmrnahmm.4.20	CCAUGGUGGUAGUUGGGGACAGCCCCACGGUGGUGGCUGG	((...((((...............))))))..........
mmrnahmm.4.21	CCAUGGGGGCGGCUGGGGACAGCCCCACGGGGGUGGCUGG	..........(((((....)))))................
mmrnahmm.4.22	GGGUGGUGGCGGCUGGGGCCAGCCCCACGGGGGUGGCUGG	.............((((((..)))))).............
mmrnahmm.4.23	CCAUGGUGGCGGCUGGGGACAGCCCCAUGGUGGCGGAUGG	((((((....(((((....)))))))))))..........
mmrnahmm.4.24	CCAUGGUGGUGGCUGGGGACAGCCACAUGGUGGUGGAGGG	((((....(((((((....)))))))))))..........
mmrnahmm.4.25	UGAGAGACAUGGCCUGGGGUCAGCCCCAUGGUAAUGGUGGG	..............((((((..)))))).............
mmrnahmm.4.26	GCAUGGUGGUGGUUGGGGACAGCCCCAUGGUGGUGGAGGCUGG	((.((..............))))....................
mmrnahmm.4.27	UGGUGGUGGUGGCUGGGGACAGCCCCAUGGUGGUGGUGGCUGG	..........(((((....)))))...................
mmrnahmm.4.28	CGGCGGUGGAGGCUGGGGACAGCCCCAUGGUGGUGGCGGCUGG	..........(((((....)))))...................
mmrnahmm.4.29	CCAGGGAGGGGGAGGCUGGGGCCAGCCCCACGGUGGUGGCUGG	((((...........))))..((((((((((.)))).))))))
mmrnahmm.4.30	CCACGGUGGUGGCUGGGGACAGCCCCAUGGUGGGGGUGGCUGG	..........(((((....)))))...................
mmrnahmm.4.31	UGUUUAGGACGACCUAAGCAGGCUCUCAAUGCGGGACGACCCGC	((((((((....))))))))..........(((((....)))))
mmrnahmm.4.32	GUUACAGGACGACCUGUAAACGCUAUUCUCACCGGGGACGGCCCC	((((((((....)))))))............(((....))))...
mmrnahmm.4.33	UAAACGGGACGACCUGUUUACGCAUCUGUAUCCGGGGACGACCCC	((((((((....)))))))).............((((....))))
mmrnahmm.4.34	CAAACGGUCCUUUUCAGGACCACAAUACAUUACUCAAGAGCUGUGU	.....((((((....)))))).........................
mmrnahmm.4.35	UUUGAGGCUUCACUAGAAGCCAUUACUAGAUACUUACAAACAAUGU	.....((((((....)))))).........................
mmrnahmm.4.36	CCUAGGGCUUACGCCCUAGGCUAUUAAAGUACGCACCUACAGCGCU	((((((((....))))))))..........................
mmrnahmm.4.37	CAGUGGGCUGAAGCCCACUGCUAUUAUAUUCCGCCGCUGCGCGGCU	(((((((((..)))))))))............(((((...))))).
mmrnahmm.4.38	CCCAGCGUUGAAACGCUGGGCUAUUCUCGGGUGUCCCUACGGGACG	(((((((((..)))))))))............(((((...))))).
mmrnahmm.4.39	CAAACGGCCCUUUUCAGGGCCACCAAACACACUCAUCAAGGAGUUG	.....((((((....)))))).........................
mmrnahmm.4.40	GUUACAGGUAUAUUUAUCCCUACUAAAAAAUGAUUUAAGUUUGAAA	..............................................
mmrnahmm.4.41	CCUAGCUCUCACGAGCUAGGCUAAUUUAUGCCGUUCCUUCAGAACU	((((((((....))))))))..........................
mmrnahmm.4.42	CCUAGCACUUGCGUGCCAGGCUGAGUUAUGCCGUGCUUUCAGCACU	(((.((((....)))).)))............(((((...))))).
mmrnahmm.4.43	CCUAGCUCUGGCGAGCCAGGCUAAGUUAUGUCGUGCUUUCAGCACU	..(((((.((((..))))))))).........(((((...))))).
mmrnahmm.4.44	CCUAGCUCUCACGAGCUAGGCUAAUUUAUACCGUGCUUUCAGCACU	((((((((....))))))))............(((((...))))).
mmrnahmm.4.45	CCUAGUUCUGACGAACUAGGCUGAUCUAUACCGUUCCUUCAGAACU	((((((((....))))))))..........................
mmrnahmm.4.46	ACCCCGGCCCUUUUCAGGGCCACCCAAAUGUCUAAGAAAGAGCUGU	.....((((((....)))))).........................
mmrnahmm.4.47	CUAAAGGCCCUUUUCAGGGCCAUCCAAUUAAUCCUCCAAAGGGUUG	.....((((((....)))))).........................
mmrnahmm.4.48	ACAACGGCUCUUUUAAGAGCCACCACAUGUGACCGAAAGAGCAUUU	.....((((((....)))))).........................
mmrnahmm.4.49	CCCAGCGCUCACGCGCUGGGCUACCAACUGGCGCCACUACGUGGCU	((((((((....))))))))............(((((...))))).
mmrnahmm.4.50	CCCACCGCUUACGCGGUGGGCCAUUGCAUGGCGUCGCUGCGCGACU	((((((((....))))))))............(((((...))))).
mmrnahmm.4.51	CCCUCCACUCACGUGGCGGGCUAUUUCAUUGCGUCGCUACGCGACU	(((..............)))............(((((...))))).
mmrnahmm.4.52	CCAACGGCCCUCUUUAGGGCCACAAAUGAUAAAUCCAAACAGUCCG	.....(((((......))))).........................
mmrnahmm.4.53	CCAACGGCCCUCUUUAGGGCCACAAAUGUGAUAAUAUCCCAUGUAA	.....(((((......))))).........................
mmrnahmm.4.54	AUCGUUCAACCCAAAAGGGUCGCAAGUAAGCCGACACGGAACGGAUA	...............................................
mmrnahmm.4.55	UCCUAGCUGCAACGGCUUCCUGGCGCAGCUUACAUUUUAUUGGAGCA	....((((((..............)))))).................
mmrnahmm.4.56	AAAUGAGGACGACCUCAUCCCUCGCGCUUUUCUCUGGGACGACCCAG	..((((((....))))))...............(((((....)))))
mmrnahmm.4.57	UACGUUCAUCCCUAUGGGACGGAAGUAAGGAAACUGAAGGAACGCACC	................................................
mmrnahmm.4.58	UUCCAGGACAUACUAAUGAGGAUGUCAAAAUUGCAGUUGGGGUCCUCA	................((((........................))))
mmrnahmm.4.59	UUCCAGGACAUACUGACAAGGAUGUCAAAAAUGCAAUUGGGGUCCUCA	................................................
mmrnahmm.4.60	CGCGAUGGACGACCAUCAUGCGGAUCGCAUUUUGGCGGGACGACCUGC	((((((((....)))))..)))............(((((....)))))
mmrnahmm.4.61	UUCCAGGACAUACUGAUGAGGAUGUCAAAAUUGCAAUUGGGGUACUCA	................................................
mmrnahmm.4.62	UUCCAGGACAUAAUGAAGAGGAUGUCAAAAAUGCAAUUGGGGUCCUCA	................................................
mmrnahmm.4.63	UUCCAGGACCUACUAGUAAGGAUGUCAAAAAUGCAAUUGGAAUCCUCA	((((((..............................))))))......
mmrnahmm.4.64	UUCCAGGACAUACUGCUGAGGAUGUCAAAAAUGCAGUUGGAGUCCUCA	................(((((((..................)))))))
mmrnahmm.4.65	UACGUUCAGGCAUCAGCCCGGAAGUAGGAGUUAUCCGAAGGAACGCACC	.................................................
mmrnahmm.4.66	CUCCUGUCACAACGGCUUCCUGGCGUGGCGGGCAACAUCCAAUGGAGCA	((((((.................................))..))))..
mmrnahmm.4.67	AUCGUUCAGCCAUGAUGGCCGGAAGUAGGUAAUACCGAAGGAACGCACC	.................................................
mmrnahmm.4.68	AUCGUUCAUCUCAUAUACGAGACGCAAAAGUUCGCUGAAGGAACGGCAU	.................................................
mmrnahmm.4.69	AACGUUCACCCGAAAGGGCGGAAGUAAGCAAUAGCUGAAGGAACGCACC	.................................................
mmrnahmm.4.70	GAAUUGCUACAACGGCUUCCUGACGUGGCGAUCUAUAUGAACUGGAGCA	.................................................
mmrnahmm.4.71	GUUCUGUCACAACGGCUUCCUGGCGUGACAGGUUUUUCAUAUCGGAGCA	...(((((((..............)))))))..................
mmrnahmm.4.72	UGUCCCCCUCAACGGCUUCCUGACGAGGCGGGCUUAACAAAACGGAGCA	((((((((((..............)))).)))....)))..........
mmrnahmm.4.73	CCCCUAGGACGACCUAGAGGGUGACUUCACCGAUGAUGGGACGACCCAA	((((((((....))))).)))............................
mmrnahmm.4.74	AUGCCGCCACAACGGCUUCCUGGCGUGGCGGAUCUCAUCCAAUGGAGCA	((((((((((..............)))))))....)))...........
mmrnahmm.4.75	GAAGCGGGACGACCCGUUUUCCCUCUUUCAUUGCGCGGGGACGACCCUG	((((((((....)))))))).............................
mmrnahmm.4.76	UGACCGCCACAACGGCUUCCUGGCGUGGCGGCGUCAUUUCAACGGAGCA	((((((((((..............))))))..)))).............
mmrnahmm.4.77	GCUUAGGGACGACCCUAAACAUGCCUUAAUUUGGUAGGGGACGACCCCU	((((((((....))))))....))...........(((((....)))))
mmrnahmm.4.78	CCGACGCUGCAACGGCUUCCUGGCGCAGCGGUCGCUAUUCAAUGGAGCA	(.((((((((..............))))).))))...............
mmrnahmm.4.79	AUCGUUCAACCCAUAUGGGUCGGAAGUAAGCAUCGCUGAAGGAACGCGCA	..................................................
mmrnahmm.4.80	UACGUUCAACCUUAUGGUCGGAAGUAAGCUUGUAGCUGAAGGAACGCGAU	..................................................
mmrnahmm.4.81	UACGUUCAACCUUAUGGUCGGAAGUAAGCUUGUAGCUGAAGGAACGCAAA	..................................................
mmrnahmm.4.82	AUCGUUUAUCCUAUACGGACGGAAGUAGGCAUUUGCCGAAGAAACGCACC	..................................................
mmrnahmm.4.83	AUCGUUCAUCCUAAAAGGACGGAAGUAAGCAUCAGCUGAAGGAACGCACC	..................................................
mmrnahmm.4.84	AACGUUCAACCUUAUGGUCGGAAGUAAGCUUGUAGCUGAAGGAACGUAUU	..................................................
mmrnahmm.4.85	UACCUGCCACAACGGCUUCCUGGCGUGGCGGGCUGAACCUCAAUGGAGCA	..((((((((..............))))))))..................
mmrnahmm.4.86	GCGCGAGGACGACCUCGGCCAAAUCGGCGACAGCAUGCGGGACGGCCCGG	((.(((((....)))))))...............................
mmrnahmm.4.87	AGGCCGGGACGACCCGGCCAUUCCCUCGGGACCCGGCCGGGACGACCCGG	.(((((((....))))))).......((((.)))).(((((....)))))
