mmrnahmm.2.1	AUUAUCGGGAGCAGUGUCUUCCAUAAU	(((((.(((((......))))))))))
mmrnahmm.2.2	AUUAUCGGGGACAGUGUUUCCCAUAAU	(((((.((............)))))))
mmrnahmm.2.3	UUUCUUCUUCAACAGUGUUUGGAUGGAAC	.............................
mmrnahmm.2.4	AUUCUUGCUUCAACAGUGUUUGAACGGAAU	(((((....................)))))
mmrnahmm.2.5	GUUCCUGCUUCAACAGUGCUUGGACGGAAC	(((((....................)))))
mmrnahmm.2.6	UUUCCUGCUUCAACAGUGCUUGGAUGGAAC	..............................
mmrnahmm.2.7	GUUCUUGCUUCAACAGUGAUUGAACGGAGC	((((...((((((......))))).)))))
mmrnahmm.2.8	CCAUGGCGGUGGCUGGGGCCAUGGAGGUGGCUCG	(((((((..........)))))))..........
mmrnahmm.2.9	CAGCGCAUUGGUUGCUGUAAGCCAAGGGCGGUAGCAUA	(((((.......))))).....................
mmrnahmm.2.10	AAGCACAUGAGGAGCUAUAACCUUAGGGCGGUAGCAUU	......................................
mmrnahmm.2.11	AAGCACUUUGGGAGCUUUAACCUAAGGGCGGUAGCGUA	..((.(((((((........))))))))).........
mmrnahmm.2.12	AAAUACCGUGGUGGCUUAAAACCAGGUGCAGCAUCCUG	......................(((((((.))).))))
mmrnahmm.2.13	GAGCGCAUUGGAAGCUGUAAUCUAGGGGCGGCAGCGUG	......................................
mmrnahmm.2.14	CAGCAAGCUCGAGGCUGGAAUUCAGGGGCGGUAGCGUU	......................................
mmrnahmm.2.15	CAGCACACUGGAGGCUGAAAUUCAGGGGCGGUAGCCAU	((((.(......))))).....................
mmrnahmm.2.16	UAGUGCACUGGUAGCUGUUAAGCCAGGGGCGGUAGCUUG	.......................................
mmrnahmm.2.17	CAGUGUAUUGGUAGCUAAAAAGCCAGGGGCGGUAGCGUG	.......................................
mmrnahmm.2.18	CCACGGAGGAGGCUGGGGUCAGCCCCACGGAGGCGGCUGG	(((..........)))...(((((((.....)).))))).
mmrnahmm.2.19	UCAUGGUGGUGGCUGGGGCCAGCCCCAUGGUGGUAGCUGG	((((((....(((((....)))))))))))..........
mmrnahmm.2.20	CCAUGGCGGUGGCUGGGGACAGCCUCACGGUGGUGGUUGG	((((..(.(((((((....)))))..))))))).......
mmrnahmm.2.21	AGGUGGUGGUGGCUGGGGACAACCCCACGGUGGUGGCUGG	.............(((((....))))).............
mmrnahmm.2.22	CCACGGUGGCGGCUGGGGUCAGCCCCACGGUGGCGGCUGG	((((.((((.(((((....))))))))).)))).......
mmrnahmm.2.23	CCAUGGUGGCGGUUGGGGGCAACCCCAUGGUGGCAGCUGG	((((((..................))))))..........
mmrnahmm.2.24	CCAUGGCGGUGGCUGGGGUCAGCCCCACGGCGGCGGCUGG	(((..........)))...(((((((.....)).))))).
mmrnahmm.2.25	CCACGGAGGUGGCUGGGGUCAGCCCCACGGAGGUGGUUGG	.............((((((..)))))).............
mmrnahmm.2.26	CCACGGGGGUGGCUGGGGUCAGCCCCACGGGGGUGGCUGG	((.(((((((...........))))).)))).........
mmrnahmm.2.27	CCAGAGCGGUGGCUGGGGGCAGCCUCAUGGUGGUGGCUGG	(((..................................)))
mmrnahmm.2.28	UCAUGGAGUGGCAGGGGACAGCCUGAUGGUGUUGAGGGUUGG	..........................................
mmrnahmm.2.29	ACAUGGUGGUGGCUGGGGACAGCCCCAUGGCGGCGGUGGCUGG	..........(((((....)))))...................
mmrnahmm.2.30	CGGUGGGGGCGGCUGGGGCCAGCCUCAUGGUGGGGGCGGCUGG	..................((((((.............))))))
mmrnahmm.2.31	UCACGGUGGCGGCGGAUGGGGCCAGCCCCACGGUGGCGGCGGA	................((((((..)))))).............
mmrnahmm.2.32	UCGAGGACGACCUCAAAAUCACCUUUUCGGCCGGGACGACCCGG	(((....)))....................(((((....)))))
mmrnahmm.2.33	CCAAAGGUGUUUUUUAACACCACACAAAAAACCAAUUUCUUUUCA	.....(((((......)))))........................
mmrnahmm.2.34	UUUUAGGCUUCACUAGAAGCCACCAACGUUUACUUCGGACGUCAU	.....((((((....))))))........................
mmrnahmm.2.35	ACAAAGGCUCUUUUAAGAGCCACAACAAGUCUGUUCAAGGAGCAU	.....((((((....))))))........................
mmrnahmm.2.36	ACAAAGGCUCUUUUCAGAGCCACCGACACUUUCUGGGAAUGAGCU	.....((((((....))))))........................
mmrnahmm.2.37	CCUAGGGCUUACGCCCUAGGCUAAUAAGUAGCGCGCCUACAGCGCU	((((((((....)))))))).........(((((.......)))))
mmrnahmm.2.38	UGGCACGCAACGGCUUCCUGACGCGUGAGAUUGAAUUAUUGGAGCA	..............................................
mmrnahmm.2.39	UAGCACGCAACGGCUUCCUGACGCGUGAGCUUUAAUUAUCGGAGCA	..............................................
mmrnahmm.2.40	UGACAGGCGUUACUAGACGCCACAAAUAGUUUAUGUUGCUCUUUGG	.....((((........)))).........................
mmrnahmm.2.41	AAAACGGCUCUUUUAGGAGCUACCACAUGCAAAAAAGUCAAUAGCC	.....(((((((((..................))))).....))))
mmrnahmm.2.42	CCUAGCUCUCACGAGCCAGGCUAUGUUAAGCCGUCCCUUCGGGACU	(((.((((....)))).)))............(((((...))))).
mmrnahmm.2.43	CCUAGUUCUCACGAACUAGGCUUAGUUAUGGCGUGCCUUCAGCACU	((((((((....))))))))..........................
mmrnahmm.2.44	CCUAGCACUCCCGUGCUAGGCUAAUGUAUGUCGUGCCUUCAGCACU	((((((((....))))))))..........................
mmrnahmm.2.45	CCUAGCACUUUCGUGCCAGGCUGUACUAUAUCGUCCCUUUGGGACU	(((.((((....)))).)))............(((((...))))).
mmrnahmm.2.46	CCUAGCACUUGCGUGCUAGGCUGAGUUAUGUCGUCCCCUUGGGACU	((((((((....))))))))............(((((...))))).
mmrnahmm.2.47	CCCAAGGCUCACGCCCUGGGCUAUUACACGUCGCUCCUUCAGAGCU	(((.(((.......))))))............((((.....)))).
mmrnahmm.2.48	CCCAGGGCUUACGCCCUAGGCUAUUUCACGUCGCCCCUCCGGGGCU	((((((((....)))))...........((.........)))))..
mmrnahmm.2.49	CCAACGGCCCUCUUUAGGGCCACAAAUAACACGAAUCCUAAAAUAU	.....(((((......))))).........................
mmrnahmm.2.50	UUUAAGGCUUCACUAGAAGCCAUUAUAUAUAAUAUACACAUAUAUA	.....((((((....)))))).........................
mmrnahmm.2.51	CAAAAGGCCCUUUUCAGGGCCCCCAAACUGUCACAGAAAGAGCUGU	.....((((((....)))))).........................
mmrnahmm.2.52	GCAGGGUGGCGGCACCUGGGGGCAGCCUCAUGGUGGUGGUGGCUGG	..............................................
mmrnahmm.2.53	CCUCGGGUUGAAACCCGAGGCUGACAAAUUUCACCGCUCCGCGGUU	(((((((((..)))))))))............(((((...))))).
mmrnahmm.2.54	CCCACCACUCACGUGGUGGGCUAUUUCAUUCCGUCGCUGCGCAACU	((((((((....))))))))..........................
mmrnahmm.2.55	CCCACCACUCACGUGGUGGGCUAUCUCGUUCCGAGCCUGUGGCACU	((((((((....))))))))....((((...))))...........
mmrnahmm.2.56	CGGGAAGGACGGCCUUCCCGCUUCUUCAACGAACGGGACGGCCCGU	(((((((......)))))))............((((......))))
mmrnahmm.2.57	CAAACGGCUCUUUUCAGAGCCACCAAAUAAUCAAGAAAGAAUACUG	.....((((((....)))))).........................
mmrnahmm.2.58	UUCGUUCAUCCCGAAAGGGACGCAAAAGCCGACUGAAGGAACGGAAC	(((((((.((((....))))............((..)))))))))..
mmrnahmm.2.59	AACGUUCAUCCCGAAAGGGACGCAAGUAAGCCGACACGGAACGGAUU	...............................................
mmrnahmm.2.60	UACGUUCAUCCCAAAAGGGACGCAAGUAAGCCGACACGGAACGGAAU	...............................................
mmrnahmm.2.61	UUCGUUCAUCCCCUUGGGGACGCAAAUGCCGACUGAAGGAACGGAUA	(((((((.(((((..)))))............((..)))))))))..
mmrnahmm.2.62	AUCGUUCAUCCCGUAAGGGACGCAAAAGCCGACUGAAGGAACGGGAU	.......(((((((..........................)))))))
mmrnahmm.2.63	UGGCUGGGACGACCCAGUUACGCAUCUGUUUUUCGGGGACGGCCCCG	((((((((....)))))))).............((((......))))
mmrnahmm.2.64	AUGUGGGGACGACCUCACCGCUCUAAUUAAUAAUGAGGACGACCUCA	..((((((....))))))...............(((((....)))))
mmrnahmm.2.65	AUCGUUCAUCCCCAAGGGGGACGCAAAUGCCGACUGAAGGAACGGGUC	..(((((...(((..)))))))).........................
mmrnahmm.2.66	ACAUGUACGCAACGGCUUCCUGGCGCGUGAACCGUAAUUAUUGGAGCA	................................................
mmrnahmm.2.67	AACGUUCAGGCGUCAAGCCCGGAAGUAGCAUUAGCGAAGGAACGCACU	................................................
mmrnahmm.2.68	AUCGUUGGACUAAAAGUCGGAAGUAAGCAAUCGCUGAAGCAACGCACU	................................................
mmrnahmm.2.69	UUCCAGGACAUACUGGUGAGGAUGUCAAAAAUGCAAUUGAGGCCCUCA	.....................................(((((.)))))
mmrnahmm.2.70	UUCCAGGACAUACUGGUGAGGAUGUCAAAAAUGCAAUUGGCAUCCCCA	...................(((((((((........)))))))))...
mmrnahmm.2.71	CCGCCGGGACGACCCGGCCAUGUACGGGUAGUUGUCAGGACGACCUGC	((((((((....)))))).......)).....................
mmrnahmm.2.72	ACUCCUCCACAACGGCUUCCUGACGUGGGGGAUUAUUUGAAUGGAGCA	..((((((((..............))))))))................
mmrnahmm.2.73	AAGUGAGGACGACCUCACCGCUCCAUCUUUUCUUCGGGGACGACCCCA	..((((((....)))))).................((((....)))).
mmrnahmm.2.74	CACCACGGACGACCGUGGCACAUGACGAAUGACGGCGGGACGGCCCGC	..((((((....))))))................((((......))))
mmrnahmm.2.75	UUCCAGGACAUACUGUUGAGGAUGUCAAAAAUGCAAUUGGGGUCCUCA	................................................
mmrnahmm.2.76	UUCCAGGACAUACUAAUGAGGAUGUCAAAAAUGCAAUUGGGAUUCUCA	................................................
mmrnahmm.2.77	UUCCAGGACAUACUGAUGAGAAUGUCAAAGAUGCAGUUGGGGUCCUCA	................................................
mmrnahmm.2.78	UUCCAGGACAUACUGAUGAGGAUGUCAAAAAUGCAAUUGGCGUCCUCG	.................(((((((((((........))))))))))).
mmrnahmm.2.79	UUCCAGGACAUACUAAGGAGGAUGUCAAAGAUGCAAUUGGGGUCCUCA	................................................
mmrnahmm.2.80	UACGUUCAGGCAUCAGGCCCGGAAGUAGCAUACAGCGAAGGAACGCACC	.................................................
mmrnahmm.2.81	GUGCUGUCACAACGGCUUCCUGGCGUGGCGGCGAAAACCUAAUGGAGCA	((((((((((..............))))))))....))...........
mmrnahmm.2.82	AUCGUUCAACCUCACUAGAGGUCGCAAGUAAGCCGACUCGGAACGGAUA	........(((((....)))))...........................
mmrnahmm.2.83	ACCCCGUCACAACGGCUUCCUGGCGUGACGGAGAAACCCGAAUGGAGCA	...(((((((..............)))))))..................
mmrnahmm.2.84	UACCUGUCACAACGGCUUCCUGGCGUGACGAGGUGACCUCAGUGGAGCA	((((((((((..............))))).)))))..............
mmrnahmm.2.85	UUACUGCCACAACGGCUUCCUGGCGUGGCAGGCUAAACCCAACGGAGCA	((((((((((..............)))))))..))).............
mmrnahmm.2.86	CGGCCGGGACGACCCGGCCGAACAAGGAGCAUGAGCCGGGACGGCCCGG	((((((((....))))))))..............((((...))))....
mmrnahmm.2.87	GCUUAGGGACGACCCUAAAUACGCCUAAUCUAACAUGGGGACGACCCCU	((((((((....))))))....))............((((....)))).
mmrnahmm.2.88	GCGCUGCCACAACGGCUUCCUGGCGUGGCGGUCUGACAGUCAAUGGAGCA	..((((((((..............))))))))..................
mmrnahmm.2.89	CUCGUUCAUCCUAAAAGGACGGAAGUAGGCUUUUGCCGAAGGAACGCACC	..................................................
mmrnahmm.2.90	AUCGUUCAACCAUAUGGUCGGAAGUAGGUUUGACACCGAAGGAACGCAUC	(((((((((((...............)))).....(....)))))).)).
mmrnahmm.2.91	CGACCGGGACGGCCCGGUCGCUUCCCUGGGGCACAGCCGGGACGACCUGG	(((((((......)))))))..((((...(((...)))))))........
