mmrnahmm.5.1	UAUAUCGGAGACAGUGAUCUCCAUAUG	(((((.(((((......))))))))))
mmrnahmm.5.2	GGUCGCGUCAACAGUGUUUGAUCGAAC	...........................
mmrnahmm.5.3	UUUCCUGGUUCAACAGUGCUUGGACGGAAC	.((((..((((((......)))))))))).
mmrnahmm.5.4	UGUCUUGCUUCAACAGUGUUUGAACGGAAC	..............................
mmrnahmm.5.5	UAUCUUGCUUCAACAGUGUUUGGACGGAAC	..............................
mmrnahmm.5.6	GUACUUGCUUCAACAGUGUUUGAACGGAAC	..............................
mmrnahmm.5.7	UCAUGGUGGUGGCUGGGGCCAUGGAGGUGGCUCG	(((((..............)))))..........
mmrnahmm.5.8	CAGCACUCGGGGAGCUGUAACCCAGUGCGGUAGCUAU	(.(((((.(((.........)))))))))........
mmrnahmm.5.9	UAGCGAACUGGGGGCUGUCACUCAGGGGCGGUAGCGUG	......................................
mmrnahmm.5.10	UAGCAGGCUGGAGGCUGUAAUCCACGGUCGGUAGCGUG	......................................
mmrnahmm.5.11	UAGCGCAUUGGUAGCUACGAACCAAGGGCGGUAGCGUG	((((.........)))).....................
mmrnahmm.5.12	CAGCGCUUUGAUAGCUGUGAGUCAAGGGCGGUAGCGUU	((((.........)))).....................
mmrnahmm.5.13	AAGCGUAUUGGUAGCAGGAAGCCAAGGGCGGUAGCGUU	......................................
mmrnahmm.5.14	UAGUGCUCUGGUAGCUGCAAGGCCAGGGGCGGUAGCGUG	.......................................
mmrnahmm.5.15	CAGUAUUCAGGUAGCUGUUGAGCCUGGGGCGGUAGCGUG	(((....................))).............
mmrnahmm.5.16	CGGUGGUGGAGGCUGGGGACAGCCCCACGGUGGAGGCUGG	(.((((....(((((....))))))))))...........
mmrnahmm.5.17	CCAUGGUGGCGGAGGCUGGGGACAGCCCUAUGGUGGCAAG	((((((.....................)))))).......
mmrnahmm.5.18	GGGUGGUGGUGGCUGGGGGCAGCCCCAUGGUGGCAGCUGG	(((....................)))..............
mmrnahmm.5.19	UCAUGGAGGUGGCUGGGGUCAGCUCCAUGGUGGUGGCUGG	(((((((................)))))))..........
mmrnahmm.5.20	CCAUGGAGGUGGCUGGGGCCAACCUCAUGGAGGAGGCUGG	((((.(((((...((....)))))))))))..........
mmrnahmm.5.21	CCAUGGUGGUGGCUGGGGACAACCUCAUGGUGGUGGCUGG	((((((..................))))))..........
mmrnahmm.5.22	UCAUGGUGGUGGCUGGGGGCAACCUCAUGGUGGCGGCUGG	((((((..................))))))..........
mmrnahmm.5.23	CCAAGAUGUGGAGGCUGGGGUCAGCCCUUGGUGGAGGUUGC	(((((.....................)))))..........
mmrnahmm.5.24	CCACAGCGGGGGGACCUGGGGUCAGCCCCAUGGAGGUAGCUGG	((.(((.........))))).......................
mmrnahmm.5.25	CCAUGGUGGCGGUGGCUGGGGACAACCCCAUGGUGGUGGUGGC	((((((.....................))))))..........
mmrnahmm.5.26	CCAUGGUGGUGGCUGGGGACAGCCACGUGGUGGUGGAGGCUGG	((((....(((((((....))))))))))).............
mmrnahmm.5.27	CCAGGGAUUUCAUCCCUGGCUAAUAUAUUUCGUGCUUUCAGCACU	((((((((...))))))))............(((((...))))).
mmrnahmm.5.28	ACCCCGGCCCUUCUCAGGGCCACACACAUAUCCCAGAAAGAUCUA	.....((((((....))))))........................
mmrnahmm.5.29	AACCCGGUGUUCUUAAACACCAAUAUUUUCCUUGAUCAUCUCUGG	.....((((((....))))))........................
mmrnahmm.5.30	CGGCGGGGACGACUCCGCCGCCCGAACAUCCACGGGGACGACCCC	((((((((....)))))))).............((((....))))
mmrnahmm.5.31	CAAACGGCCCUUUUCAGGGCCACCAAUUGUGUUGAAAAGAACUUAU	.....((((((....)))))).........................
mmrnahmm.5.32	AUCGUUCAUCCCAAUGGGACGCAAGUAAGCCGACUCGGAACGGAUU	........(((((.)))))...........................
mmrnahmm.5.33	ACACUGGAUUUUAUAAAAUCCACUCAUCAAUCAAAGAACUUCUUAU	....(((((((....)))))))........................
mmrnahmm.5.34	CCCAGCAGUGAACUGCUGGGCUACUAUCAGAUGUCCCUUCGGGACA	(((((((((..)))))))))...........((((((...))))))
mmrnahmm.5.35	AAAACGGCCCUUUUCAGGGCCACUAGAGCAUUCCCUAAAAGAGUUG	.....((((((....)))))).........................
mmrnahmm.5.36	AUCAGGGCUUCACUUGAAGCCGUCUAAUGUAUCUAAUGUUUUUUAC	.....(((((((..))))))).........................
mmrnahmm.5.37	UAAUUGGAUUUUUUGAAAUCCACCUGCAGUAGGAUAAAGGAGAUGU	....((((((......))))))........................
mmrnahmm.5.38	CCUAGCACUGCCGUGCCAGGCUGAGUUAUGGCGUGCUUUCAGCACU	...(((((.((((...............))))))))).........
mmrnahmm.5.39	CCUAGCUCUCACGAGCCAGGCUGAACUAUAACGUACCUUCGGUACU	(((.((((....)))).)))............(((((...))))).
mmrnahmm.5.40	CCUAGCUCUCACAAGCUAGGCUGUGUUAUGUCGUACCUUUGGUACU	(((((((......)))))))..........................
mmrnahmm.5.41	CCUAGUUCUGACGAACCAGGCUCAGUUAUGCCGUGCUUUCAGCACG	(((.((((....))).))))...........((((((...))))))
mmrnahmm.5.42	CGUGUGGCUCACGCCACACGCUACAUUAUGUCGGGCUUCCAGCCCU	((((((((....))))))))............(((((...))))).
mmrnahmm.5.43	AAACCGGUGUUCUUAAACACCAACUAGCCAAAGAUCAUCUCUCAAA	.....((((((....)))))).........................
mmrnahmm.5.44	UAAUCGGUCCUUUUCAGGACCAAAAACCAGAUUCAAUGAGAUAAAA	.....((((((....)))))).........................
mmrnahmm.5.45	CCAUGGUGGUGGAGGCUGGGGUCAGCCCCAUGGUGGUGGAGGCUGG	((((((.....................)))))).............
mmrnahmm.5.46	CCAUGGUGGUGGAGGAUGGGGUCAGCCUCAUGGUGGUGGCGGUUGG	((((((.....................)))))).............
mmrnahmm.5.47	CCAUGGCGGCGGAGGCUGGGGUCAGCCCCACGGGGGUGGAGGCUGG	(((.............)))...(((((.............))))).
mmrnahmm.5.48	CCAGGGAGGCGGAGGCUGGGGUCAGCCCCAUGGGGGUGGAGGCUGG	(((.............)))...(((((.............))))).
mmrnahmm.5.49	CCCACCGCUUACGCGGUGGGCUAUUUCAUUCCGUCGCUGCGCGACU	((((((((....))))))))............(((((...))))).
mmrnahmm.5.50	CCCACCUCUUACGAGGUGGGCUAUUUUCUUGCGUGCCUUCGGGACU	((((((((....))))))))..........................
mmrnahmm.5.51	CCCACCGCUUACGCGGUGGGCUAUUACGUGGCGUCGCUUCGCGACU	((((((((....))))))))............(((((...))))).
mmrnahmm.5.52	CUCGCUUCGGAAGUGGUGGGCUAUUGCAUCGCGUGCCUUCGGCACU	................................(((((...))))).
mmrnahmm.5.53	AUCGUUCAGUCCCAUAAGGGACCGCAAGUAAGCCGACACGGAACGGA	........(((((....))))).........................
mmrnahmm.5.54	AUCGUUCAUCCUAAAGGACGGAAGUAGGCUAGCCGAAGGAACGCACU	...............................................
mmrnahmm.5.55	GUCGUUCAUCCAUAAGGACGGAAGUAGGGAAACCGAAGGAACGCAUC	...............................................
mmrnahmm.5.56	UUUGCAGGACGACCUGCAAACGCCUCUUUUCACCGGGGAUGGCCCCA	((((((((....))))))))...........................
mmrnahmm.5.57	GCCGCGGGACGACCCGUGGCCGAUACGCAACCGGCAGGACGACCUGC	((((((((....)))))))).............(((((....)))))
mmrnahmm.5.58	AACCACGGACGGCCGUGGCACUGAUGAAUAAAGGCGGGACGGCCCGC	..(((((......)))))...............((((......))))
mmrnahmm.5.59	AAGUGAGGACGACCUCACCGCUCUUAUCACUAUCGGGGACGACCCCA	..((((((....))))))................((((....)))).
mmrnahmm.5.60	UACGUUCAUCCUACGGGACGGAAGUAGCACUAAGCGAAGGAACGCACU	................................................
mmrnahmm.5.61	UACGUUCAUCCCACAGGGACGGAAGUAGCGAAAGCGAAGGAACGCACU	(((.(((.((((...))))..)))))).....................
mmrnahmm.5.62	UUCGUUCAGGCACUGGCCCGGAAGUAGCAUACAGCGAAGGAACGCACC	((((((..........................))))))..........
mmrnahmm.5.63	UGAUGCACGCAACGGCUUCCUGACGCGUGAGAUUAAAUUAUUGGAGCA	................................................
mmrnahmm.5.64	UACGUUCAUCCCACUGGGACGGAAGUAGCACAAGCGAAGGAACGCACU	(((.(((.(((((.)))))..)))))).....................
mmrnahmm.5.65	UCCCCGUCACAACGGCUUCCUGGCGUGGCGGAUGACCCUAAUGGAGCG	...(((((((..............))))))).................
mmrnahmm.5.66	UAAGGCUUACAACGGCUACCUGAAGUAAGUUGACAUAAAAACGGAGCA	................................................
mmrnahmm.5.67	UGCCAGGACAUUCUGCAGAGAAUGUCAAAGAUGCAAUUGGAAUCCUCA	......(((((((......)))))))......................
mmrnahmm.5.68	UGCCAGGACAUACUACAGAGGAUGUCAAAAAUGCAAUUGGAAUCCUCA	................................................
mmrnahmm.5.69	UACCAGGACAUUCUACAGAGGAUGUCAAAAAUGCAAUUGGAGUCCUCA	................................................
mmrnahmm.5.70	UUCCAGGACAUAAUGGUGAGGAUGUCAAGAAUGCAAUUGGCGUCCUCA	................((((((((((((........))))))))))))
mmrnahmm.5.71	AGCAACGGACGACCGUUGCGUAGAUAGAUCAAUAGCGGGACGGCCCGC	.(((((((....)))))))...............((((......))))
mmrnahmm.5.72	CGUCGGGGACGACCCCGGCGCUCAUCGAAAAACUGCGGGACGGCCCGC	((((((((....))))))))..............((((......))))
mmrnahmm.5.73	CCAAGAGGACGACCUCCCAAUCACCCAAAUGACGCAGGGACGACCCUG	..................................(((((....)))))
mmrnahmm.5.74	UUUCAGGACAUACUGGUGAGGAUGUCAAAAGUGCAAUUGGCGUCCUCA	................((((((((((((........))))))))))))
mmrnahmm.5.75	UGCCAGGACAUUCUGGAGAGGAUGUCAAAAAUGCAAUUGGAAUCCUCA	................................................
mmrnahmm.5.76	AUCUCGCCACAACGGCUUCCUGACGUGGCGGCAGAACCCUAAUGGAGCA	.(((((((((..............))))))..)))..............
mmrnahmm.5.77	GCGACCCCACAACGGCUUCCUGGCGUGGGGACACACACAUAAUGGAGCA	....((((((..............))))))...................
mmrnahmm.5.78	UACGUUCAUCCUCGCAAGAGGACGCAAAAGCCGACUGAAGGAACGGAUG	........(((((....)))))...........................
mmrnahmm.5.79	UUCGUUCAUCUCCUACGGGAGACGCAAAAGCCGACUGAAGGAACGGGAA	(((((((.((((((..))))))............((..))))))..)))
mmrnahmm.5.80	AGAGCAUCACAACGGCUUCCUGACGUGGUGCGUAAUUUUUAUUGGAGCA	...(((((((..............)))))))..................
mmrnahmm.5.81	ACUCGUCCGCAACGGCUUCCUGACGCGGAUCGACAUUUAAACUGGAGCA	..((((((((..............))))).)))................
mmrnahmm.5.82	AGGCGGGGACGACCCCGCUGGAGGUGUUUUUCAGGCGGGGACGACCCCG	.(((((((....)))))))................(((((....)))))
mmrnahmm.5.83	AUCGUUCAUCCUCUUAAAGAGGACGCAAGUAAGCCGACUCGGAACGGAAU	........(((((((.)))))))...........................
mmrnahmm.5.84	AUCGUUCAUCCAUUACGGACGGAAGUAGGCAACAGCUGAAGGAACGCGCU	..................................................
mmrnahmm.5.85	AUGCCGCCCCAACGGCUUCCUGACGGGGCGGAUUCACUUUAAAUGGAGCA	((.(((((((..............))))))))).................
mmrnahmm.5.86	CAACCGUCACAACGGCUUCCUGGCGUGACGGGGUUAACCCCAACGGAGCA	(..(((((((..............))))))))..................
mmrnahmm.5.87	GCCGGGGGACGACCCCACGGCCGGGACGAUCGCCCGCGAGGACGGCCUCG	((((((((....)))).)))).............................
