mmrnahmm.3.1	AUUAUCGGAAGCAGUGCCUUCCAUAAU	(((((.(((((......))))))))))
mmrnahmm.3.2	GUUCCUGCUUCAACAGUGAUUGAACGGAAC	(((((....................)))))
mmrnahmm.3.3	GUUCUUGCUUCAACAGUGCUUGAACGGAAC	((((...((((((......))))).)))))
mmrnahmm.3.4	AGUCUUGCUUCAACAGUGAUUGAACGGAAC	..............................
mmrnahmm.3.5	AUUCUUGCCUCAACAGUGAUUGAACGGAAC	..............................
mmrnahmm.3.6	GUUCUUGCUUCAACAGAGAUUGAACGGAAC	((((...((((((......))))).)))))
mmrnahmm.3.7	GUUCUUGCUUCAACAGUAUUUGAACGGAAC	(((((....................)))))
mmrnahmm.3.8	CACACUGGGAGCUGUAACUCAGGGGCGGUAGCUAU	(.(.(((((........)))))))...........
mmrnahmm.3.9	CAGCAUACAGGGAGCUGAAACCCCGUGCGGUAGCUAU	((((.........))))....................
mmrnahmm.3.10	UAGCGUAUUGGUAGCUGGAAGCCAAGGGCGGUAGCGUG	......................................
mmrnahmm.3.11	CAGUGCAUUGGCUGCUGUGAGCCAAGGGCGGUAGCGUU	.......(((((........))))).............
mmrnahmm.3.12	CAGUGGAUUGGUAACUGAAAGCCAAGGGCGGUAGCGUG	((((.........)))).....................
mmrnahmm.3.13	GGGCAAUAUAGAGGCCGCAAUCUAUGGGCGGUAGCGUG	......................................
mmrnahmm.3.14	CAGCAAUCUAGAAGCUGUAAUCUAGUGGCGGUAGCGUG	((((.........)))).....................
mmrnahmm.3.15	CAGCAAUCUGGGGGCUGUAACCCAGGGGCGGUAGCUAU	.......(((((........))))).............
mmrnahmm.3.16	CAGCGAACUGGGGGCUGUAACUCAGGGGCGGUAGCCAA	(((....)))............................
mmrnahmm.3.17	CGGUGGAGGUGGCUGGGGUGCCCCAUCGCGGGUGGCUGG	((((((................))))))...........
mmrnahmm.3.18	UCAUGGCGGGGGCUGGGGUCAGCCUCAUGGCGGUGGCUGG	((((((..................))))))..........
mmrnahmm.3.19	UCAUGGUGGUGGCUGGGGGCAGCCCCAUGGUGGUGGUUGG	((((((..................))))))..........
mmrnahmm.3.20	CCAUGGUGGUGGCUGGGGACAGCCUCAUGGUGGCAGCUGG	((((((....(((((....)))))))))))..........
mmrnahmm.3.21	CCAUGGUGGCAGCUGGGGACAGCCCCAUGGUGGUGGUAGC	((((((..................))))))..........
mmrnahmm.3.22	GGGCGGUGGCGGCUGGGGUCAACCCCAUGGUGGUGGUUGG	.............((((((..)))))).............
mmrnahmm.3.23	UCAUGGUGGCGGCUGGGGACAGCCCCACGGUGGUGGUUGG	.....((((.(((((....)))))))))............
mmrnahmm.3.24	UCAUGGAGGUGGCUGGGGCCAGCCUCAUGGAGGUGGCUGG	..........(((((....)))))................
mmrnahmm.3.25	CCAUGGUGGUGGAUGGGGACAGCCCCAUGGUGGUGGCUGG	((((((..................))))))..........
mmrnahmm.3.26	CCAGGGUGGUGGCUGGGGGCAACCCCAUGGUGGCGGCUGG	.............(((((....))))).............
mmrnahmm.3.27	CCACGGUGGUGGCUGGGGACAACCCCAUGGGGGCAGCUGG	((((....)))).(((((....))))).............
mmrnahmm.3.28	UCAUGGUGGUAGUUGGGGUCAGCCCCAUGGCGGUGGAUGG	((((((..................))))))..........
mmrnahmm.3.29	UCGUAAGGACGACCUUGCGUUUUCACGAACGGGGACGGCCCC	((((....................))))..(((......)))
mmrnahmm.3.30	CCAAGGAGGUGGAGGCUGGGGACAGCCUCAUGGAGGUGGCUGG	...........(((((((....)))))))..............
mmrnahmm.3.31	UCAGGGAGGGGGUGGCUGGGGUCAGCCCCAUGGAGGUGGCUGG	......................(((((((.....)).))))).
mmrnahmm.3.32	CCACGGAGGCGGCUGGGGACCCAGCUCUCUGGGAGGUGGUGGG	((.(((((..(((((((..))))))))))))))..........
mmrnahmm.3.33	CCAGGGAGGGGGUGGCUGGGGACAGCCCCACGGAGGUGGCUGG	.............(((((....)))))................
mmrnahmm.3.34	AUCGUUCAACCCAUACGGGUCGCAAGUAAGUCACGGAACGGAGC	............................................
mmrnahmm.3.35	GCGCCGGGACGACCCGGCGCGUGUACUGGCCUGAGGACGACCUCG	((((((((....)))))))).........................
mmrnahmm.3.36	CUUCCGGGACGACCCGGAGGCAAAAGAAUCCGGCGGGACGACCCG	((((((((....)))))))).............((((....))))
mmrnahmm.3.37	GCCCGGGGACGACCCCGGGUCAUUCGAUUCAACGGGGACGGCCCC	((((((((....)))))))).............(((......)))
mmrnahmm.3.38	CCAAAGGCUCUUUUAAGAGCCACCCAUUUCAUCUGUGAAAGAGCA	.....((((((....))))))........................
mmrnahmm.3.39	CCUAGGGCUUACGCCCUAGGCUAAUAAGGUACGGGCCUUCAGCCCU	((((((((....))))))))............((((.....)))).
mmrnahmm.3.40	AAACUGGAUUUUCUAAAAUCCACCCACUUUCCAAAGAACUAAGAUU	....(((((((....)))))))........................
mmrnahmm.3.41	CCCACGGCUGACGCUGUGGGCUACUCUGUGACGCCGCUACGCGGCU	((((((((....))))))))............(((((...))))).
mmrnahmm.3.42	CCCAGCGAUGAAUCGCUGGGCUAUUUUCGAGCGUCCCGGCGGGACG	(((((((((..)))))))))...........((((((...))))))
mmrnahmm.3.43	CAAACGGCUCUUUUCAGAGCCACCACAACCCCAAGAAAGAAUCAUU	.....((((((....)))))).........................
mmrnahmm.3.44	UUUUAGGCUUCACUAGAAGCCACCACAGUUUCCUUUCUCGAAGCAG	.....((((((....)))))).........................
mmrnahmm.3.45	CAAACGGUUCUUUUAGGAACCACCACAUAUGACAAGAGUCAUGUCC	.....((((((....)))))).........................
mmrnahmm.3.46	CCUAGCUCUGACGAGCUAGGCUAAGUUAAUACGUACUUACAGCACU	((((((((....))))))))..........................
mmrnahmm.3.47	CCUAGCACUUCCGUGCCAGGCUGAGUUAUGCCGUCCCAUUGGGACU	(((.((((....)))).)))............((((((.)))))).
mmrnahmm.3.48	CCUAGCUCUCACGAGCCAGGCUGAACUAUACCGUACUCUCGGUACU	(((.((((....)))).)))..........................
mmrnahmm.3.49	ACUAGCACUGACGUGCUAGGCUGAGUUAUGCCGUACCUUCGGUACU	.(((((((....))))))).............(((((...))))).
mmrnahmm.3.50	CCUGGCACUUCCGUGCCAGGCUAAUGUAUGUCGUGCUUUCAGCACU	((((((((....))))))))............(((((...))))).
mmrnahmm.3.51	UCUAGCUCUCACGAGCUAGGCUAAAUCAUGGCGUGCUUUCAGCACU	((((((((....))))))))............(((((...))))).
mmrnahmm.3.52	CCCAAGGCUCACGCCUUGGGCUUUAUUAUUUCAUGCCUUCAGCAUU	((((((((....))))))))..........................
mmrnahmm.3.53	AACUCGGUGUUUCUCAACACCACCUAGACAAAGAAUCGGAUGUGCU	.....((((((....)))))).........................
mmrnahmm.3.54	CCUUGGGUUGAAACCCAAGGCUGCCAGAUUCCGUCGCUCCGCGACU	(((((((((..)))))))))............(((((...))))).
mmrnahmm.3.55	CCAAAGGCUCUUUUAAGAGCCACUCACAUCUUGUAAAGAGUAGAAU	.....((((((....)))))).........................
mmrnahmm.3.56	ACAACGGCUCUUUUAAGAGCCACUCACUUUCUACUAAGAGCAGCGU	.....((((((....)))))).........................
mmrnahmm.3.57	CCAAAGGCUCUUUUAAGAGCCACCACGUUGCCACUGGGGAGAGCUG	.....((((((....)))))).........................
mmrnahmm.3.58	CCAAAGGCUCUUUUCAGAGCCACCCACGCUGUCAAGGGAAGAGCCU	....(((((((((((....................)))))))))))
mmrnahmm.3.59	AUCGUUCAUCCCAUAAGGGACGCAAAAGCCGACUGAAGGAACGGGAU	.......(((((..............................)))))
mmrnahmm.3.60	UACGUUCAUCCAAUGGGACGGAAGUAGGGAAACCGAAGGAACGCACU	...............................................
mmrnahmm.3.61	UAUCCGGGACGACCUGGAUAUACUGCCGUUUUCUGGGGACGACUCCA	((((((((....))))))))...........................
mmrnahmm.3.62	CUUCGGGACGACCCGAAGAAAUCUAUGACAGCCUGGGAACGGCCCAG	(((((((....)))))))..............((((.......))))
mmrnahmm.3.63	GUGCAGGGACGGCCUUGCUUUCUUCUAUCCGGAUGAGGACGGCCUCA	..........((((..........................))))...
mmrnahmm.3.64	UCCUACACGCAACGGCUUCCUGACGCGUGAGGUGUAAUCAUUGGAGCA	.(((.(((((..............))))))))................
mmrnahmm.3.65	AUCGUUUGGCUCAUUGAGUUGGAAGUAAGGUAACUGAAGAAACGCACU	................................................
mmrnahmm.3.66	UGAAACUUAUAACGGCUACCUGAAGUAAGUUUUUUUAUAAACGGAGCA	................................................
mmrnahmm.3.67	AAUCCCCCACAACGGCUUCCUGGCGUGGCGGUGACAUUCAAUGGAGCA	................................................
mmrnahmm.3.68	UUUCAGGACAUACUGAAGAGGAUGUCAAGAAUGCAAUUGGGGUCCUCA	((((((......))))))..............................
mmrnahmm.3.69	UGCCAGGACAUUCUCAUGAGGAUGUCAAAAAUGCAAUUGGAAUCCUCA	................(((((((..................)))))))
mmrnahmm.3.70	UUCCAGUACAUACUGAUGAGGAUGUCAAAAAUGCAAUUGGGGUCCUAA	................................................
mmrnahmm.3.71	UGCCGUGGACGACCUCGGCAUGCAUGACCACGUGGCGGGACGACCCGC	(((((..........)))))..............(((((....)))))
mmrnahmm.3.72	UUCCAGGACAUACUAGCGAGGAUGUCAAAAAUGCAAUUGGAAUCCUCA	((((((..............................))))))......
mmrnahmm.3.73	UCCCAGGACAUACUGAUGAGGAUGUCAAAAAUGCGAUUGGGGUCCUCA	((((((..............................))))))......
mmrnahmm.3.74	UUCCAGGACAUACUGAUGAGGAUGUCAAAAAUGCAAUUGGGACCCUCA	................(((((......................)))))
mmrnahmm.3.75	ACGUCGUCACAACGGCUUCCUGGCGUGACGAUACACAUCUAAUGGAGCA	..((((((((..............)))))))).................
mmrnahmm.3.76	AUCGUUCAUCCUCUAAUGAGGACGCAACAGUUUGCUGAAGGAACGGGAA	.................................................
mmrnahmm.3.77	AUCGUUCAACCUCAUAAGAGGUCGCAAGUAAGCCGACUCGGAACGGAUC	........(((((....)))))...........................
mmrnahmm.3.78	AUCGUUCAUCCUCUUCGGAGGACGCAAAUGCCGACUGAAGGAACGGGAU	(((((((...(..(((((................))))))))))..)))
mmrnahmm.3.79	UCCCCGUCACAACGGCUUCCUGGCGUGACGGCUGGUACCCAAUGGAGCA	...(((((((..............)))))))..................
mmrnahmm.3.80	AACCCGUCACAACGGCUUCCUGGCGUGACGGCUGACAUACAAUGGAGCA	...(((((((..............)))))))..................
mmrnahmm.3.81	UUUUAUCCACAACGGCUUCCUGAAGUGGAUCGACAUUUAAACUGGAGCA	....((((((..............))))))...................
mmrnahmm.3.82	AGACUGCCACAACGGCUUCCUGACGUGGUGGAAAAAUCUUACUGGAGCA	.................................................
mmrnahmm.3.83	CCCUGGGGACGACCCCGGCGGCCAAGGCUAUAAAGACGGGACGGCCCGU	((((((((....)))))).))............................
mmrnahmm.3.84	CGGCCGGGACGACCCGGCCGCACAGGGAGCAUGAGCCGGGACGACCCGG	((((((((....))))))))...............(((((....)))))
mmrnahmm.3.85	AUCGUUCAUCUCCUUAGGGAGACGCAAAAGUCUGACUGAAGGAACGGAAA	........((((((..))))))............................
mmrnahmm.3.86	GACGUUCAUCACAAAUGUGACGGAAGUACCAAUGAGGGAAGGAACGCACC	..................................................
mmrnahmm.3.87	AUCGUUCAUCCCAAAAGGACGGAAGUAGGCAUUAGCCGAAGGAACGCACC	..................................................
mmrnahmm.3.88	CACGUUCAUCCUAUCAAGGACGGAAGUAGCAUAACGCGAAGGAACGCACC	(.(((((..........))))))...........................
mmrnahmm.3.89	AUCGUUCAUCUAUUAUAGACGGAAGUAGGUAUACACCGAAGGAACGCACC	..................................................
mmrnahmm.3.90	CCGCUGUCCCAACGGCUUCCUGACGGGACGGUAUGACAUCCAUCGGAGCG	((((((((((..............)))))))............)))....
